Added=Ajouté
AttributeWithComponentCode=Vous ne pouvez pas supprimer un attribut de récompense lorsqu’il est lié à un code composant.
AutoCharge=Frais automatiques
 ;Label for charge component
BasePrice=Prix de base
CalculationSequence=Séquence de tarification
 ;Label for pricing calculation sequence
CannotDeleteDefaultTree=Impossible de supprimer l’arborescence des tarifs par défaut.
CannotInsertPriceTree=Une seule arborescence de tarification est autorisée.
Channel=Canal
 ;Label for channel attribute.
ConcurrencyMode=Mode concurrentiel
Customer=Client
 ;Label for customer attribute.
DefaultPriceTree=Arborescence de tarification par défaut
 ;Label for default price tree
Deleted=Supprimé(e)
DeletePriceAttribute=Vous êtes sur le point de supprimer un enregistrement dans les attributs de tarifs. Supprimer l’enregistrement ?
Discount=Escompte
 ;Label for discount component
Draft=Brouillon
Fields=Champs
MaxAttributeNumber=Vous ne pouvez pas définir plus de %1 attributs pour un composant de prix.
MoveDown=Déplacer vers le bas
MoveUp=Déplacer vers le haut
PostingProfileName=Profil de validation
 ;Label for posting profile name
PriceAdjustment=Ajustement de prix
 ;Label for price adjustment component
PriceAdjustmentAttributes=Attributs de tarification pour les ajustements de prix
 ;Label for price adjustment attributes
PriceAttrbuteSource=Source
 ;Label for the source of price attributes
PriceAttribute=Attribut de prix
PriceAttributeCatalog=Catalogue
PriceAttributeColor=Couleur
PriceAttributeConfiguration=Configuration
PriceAttributeCustAccountNum=Compte client
PriceAttributeCustGroup=Groupe de clients
PriceAttributeCustMarkupGroup=Groupe de frais client
PriceAttributeCustSegment=Segment
PriceAttributeCustType=Type de client
PriceAttributeDataType=Type de données d’attribut de prix
 ;It's not public facing.
PriceAttributeDlvMode=Mode de livraison
PriceAttributeDlvModeMarkupGroup=Groupe de frais de livraison
PriceAttributeItemMarkupGroup=Groupe de frais sur article
PriceAttributeName=Nom
 ;Label for the name of price attributes
PriceAttributeProcessStatus=Statut du processus
 ;Label for price attribute process status
PriceAttributeProduct=Produit
PriceAttributeProductCategory=Catégorie
PriceAttributeProductVariant=Variante de produit
PriceAttributeProviderNotFound=Aucun fournisseur d’attribut de prix trouvé pour %1.
 ;An error indicating customization is not correct.
PriceAttributeProviderNotSupported=Le fournisseur %1 ne prend pas en charge l’attribut de prix %2.
 ;An error indicating customization is not correct.
PriceAttributePublish=Les attributs de prix ont été correctement publiés.
PriceAttributeRetailAffiliation=Affiliation
PriceAttributeRetailLoyaltyTier=Programme de fidélité
PriceAttributes=Attributs de prix
 ;Label for price attributes form
PriceAttributeSite=Site
PriceAttributeSize=Taille
PriceAttributeStatus=Statut d’attribut de prix
 ;It's not public facing.
PriceAttributeStyle=Style
PriceAttributeType=Type
 ;Label for price attribute types
PriceAttributeTypeCustomFields=Champs personnalisés
 ;Label for customization pricing attributes
PriceAttributeTypeEcoResAttribute=Attributs définis par l’utilisateur
 ;Type of an attribute references EcoResAttribute
PriceAttributeTypePredefinedFields=Champs prédéfinis
 ;Type of a predefined attribute field
PriceAttributeWarehouse=Entrepôt
PriceComponent=Composant de prix
 ;Label for price component
PriceComponentCodeCurrencyMode=Mode concurrentiel
 ;Label for price component code concurrency mode
PriceComponentCodeName=Code de composant de prix
 ;Label for price component code name
PriceComponentCodes=Codes de composant de prix
 ;Label for price component codes form
PriceGroupAttributes=Attributs de tarification pour les groupes de prix
 ;Price attributes for price groups
PriceGroupPricingRuleLink=Liaison entre le groupe de prix et la règle de tarification
 ;Label for PriceGroupPricingRuleLink table
PriceGroups=Groupes de prix
 ;Label for price group
PricePublishStatus=Statut de publication
PriceTrees=Arborescences des prix
 ;Label for price trees
PricingRuleApplicabilities=Valeurs d’attribut de prix
 ;Label for pricing rule applicability
PricingRuleApplicabilityLookupReference=Références d’application des règles de tarification
 ;Label for pricing rule applicability references
PricingStructure=Structure de tarification
Product=Produit
 ;Label for product attribute.
ProductDiscount=Escompte de produit
 ;Label for discount component
ProductDiscountAttributes=Attributs de prix pour les escomptes de produit
Published=Publié(e)
Publishing=Publication
Rank=Rang
 ;Priority for price rules.
Rebate=Remise
 ;Label for rebate component
Revert=Rétablir
SalesAgreement=Convention de vente
SalesOrderHeader=En-tête de commande vente
 ;Label for sales order header attribute.
SalesOrderLine=Ligne de commande vente
 ;Label for sales order line attribute.
SalesTradeAgreement=Entente commerciale sur les ventes
 ;Label for trade agreement component
ShippingDiscount=Escompte sur expédition
ShippingDiscountAttributes=Attributs de prix pour les escomptes d’expédition
TenderDiscount=Escompte lié au mode de paiement
TenderDiscountAttributes=Attributs de prix pour les escomptes de l’offre
TradeAgreementAttributes=Attributs de prix pour les ententes commerciales
 ;Price attributes for trade agreements
UnifiedPricingFeatureLabel=(Incomplet) Gestion de la tarification
 ;Feature name for unified pricing management
UnifiedPricingFeatureSummary=Le module Gestion de la tarification fournit une plateforme centralisée permettant aux responsables des prix de planifier, configurer, gérer, simuler et contrôler les stratégies de prix omnicanales. Grâce à cette fonctionnalité, les entreprises peuvent mettre en place des structures de prix flexibles en utilisant plusieurs composants de prix tels que les prix de base généraux, les offres à long terme, les promotions à court terme et les remboursements rétrospectifs. Les règles de tarification peuvent être définies en fonction des attributs du produit, du client et de la commande. La tarification contextuelle peut être déployée sur différents segments en fonction de conditions prédéfinies. Le calcul des prix en temps réel est assuré par un moteur de tarification unifié qui fonctionne de manière cohérente à travers la chaîne d’approvisionnement, la vente au détail et les processus d’entreprise du e-commerce.
 ;Feature summary for unified pricing management
