Added=เพิ่ม
AttributeWithComponentCode=คุณไม่สามารถลบคุณลักษณะราคาได้เมื่อเชื่อมโยงกับโค้ดส่วนประกอบแล้ว
AutoCharge=ค่าธรรมเนียมอัตโนมัติ
 ;Label for charge component
BasePrice=ราคาฐาน
CalculationSequence=ลำดับการกำหนดราคา
 ;Label for pricing calculation sequence
CannotDeleteDefaultTree=ไม่สามารถลบผังราคาเริ่มต้น
CannotInsertPriceTree=อนุญาตให้มีเพียงผังราคาเดียว
Channel=ช่องทาง
 ;Label for channel attribute.
ConcurrencyMode=โหมดการเกิดพร้อมกัน
Customer=ลูกค้า
 ;Label for customer attribute.
DefaultPriceTree=ผังราคาเริ่มต้น
 ;Label for default price tree
Deleted=ลบแล้ว
DeletePriceAttribute=คุณกำลังจะลบเรกคอร์ดในคุณลักษณะราคา ลบเรกคอร์ดหรือไม่
Discount=ส่วนลด
 ;Label for discount component
Draft=ร่าง
Fields=ฟิลด์
MaxAttributeNumber=คุณไม่สามารถกำหนดมากกว่า %1 คุณลักษณะสำหรับส่วนประกอบราคาได้
MoveDown=ย้ายลง
MoveUp=ย้ายขึ้น
PostingProfileName=โปรไฟล์การลงรายการบัญชี
 ;Label for posting profile name
PriceAdjustment=การปรับปรุงราคา
 ;Label for price adjustment component
PriceAdjustmentAttributes=คุณลักษณะราคาสำหรับการปรับปรุงราคา
 ;Label for price adjustment attributes
PriceAttrbuteSource=แหล่งที่มา
 ;Label for the source of price attributes
PriceAttribute=คุณลักษณะราคา
PriceAttributeCatalog=แค็ตตาล็อก
PriceAttributeColor=สี
PriceAttributeConfiguration=การกำหนดค่า
PriceAttributeCustAccountNum=บัญชีลูกค้า
PriceAttributeCustGroup=กลุ่มลูกค้า
PriceAttributeCustMarkupGroup=กลุ่มค่าธรรมเนียมของลูกค้า
PriceAttributeCustSegment=เซ็กเมนต์
PriceAttributeCustType=ชนิดลูกค้า
PriceAttributeDataType=ชนิดข้อมูลคุณลักษณะราคา
 ;It's not public facing.
PriceAttributeDlvMode=วิธีการจัดส่ง
PriceAttributeDlvModeMarkupGroup=กลุ่มค่าธรรมเนียมการจัดส่ง
PriceAttributeItemMarkupGroup=กลุ่มค่าธรรมเนียมสินค้า
PriceAttributeName=ชื่อ
 ;Label for the name of price attributes
PriceAttributeProcessStatus=สถานะกระบวนการ
 ;Label for price attribute process status
PriceAttributeProduct=ผลิตภัณฑ์
PriceAttributeProductCategory=ประเภท
PriceAttributeProductVariant=ผลิตภัณฑ์ย่อย
PriceAttributeProviderNotFound=ไม่พบตัวให้บริการคุณลักษณะราคาสำหรับ %1
 ;An error indicating customization is not correct.
PriceAttributeProviderNotSupported=ตัวให้บริการ %1 ไม่รองรับคุณลักษณะราคา %2
 ;An error indicating customization is not correct.
PriceAttributePublish=เผยแพร่คุณลักษณะราคาเรียบร้อยแล้ว
PriceAttributeRetailAffiliation=การเข้าสังกัด
PriceAttributeRetailLoyaltyTier=โปรแกรมตอบแทนลูกค้าสมาชิก
PriceAttributes=คุณลักษณะราคา
 ;Label for price attributes form
PriceAttributeSite=ที่ตั้ง
PriceAttributeSize=ขนาด
PriceAttributeStatus=สถานะคุณลักษณะราคา
 ;It's not public facing.
PriceAttributeStyle=ลักษณะ
PriceAttributeType=ชนิด
 ;Label for price attribute types
PriceAttributeTypeCustomFields=ฟิลด์ที่กำหนดเอง
 ;Label for customization pricing attributes
PriceAttributeTypeEcoResAttribute=คุณลักษณะที่ผู้ใช้กำหนด
 ;Type of an attribute references EcoResAttribute
PriceAttributeTypePredefinedFields=ฟิลด์ที่กำหนดไว้ล่วงหน้า
 ;Type of a predefined attribute field
PriceAttributeWarehouse=คลังสินค้า
PriceComponent=ส่วนประกอบราคา
 ;Label for price component
PriceComponentCodeCurrencyMode=โหมดการเกิดพร้อมกัน
 ;Label for price component code concurrency mode
PriceComponentCodeName=รหัสส่วนประกอบราคา
 ;Label for price component code name
PriceComponentCodes=รหัสส่วนประกอบราคา
 ;Label for price component codes form
PriceGroupAttributes=คุณลักษณะราคาสำหรับกลุ่มราคา
 ;Price attributes for price groups
PriceGroupPricingRuleLink=การเชื่อมโยงระหว่างกลุ่มราคากับกฎการกำหนดราคา
 ;Label for PriceGroupPricingRuleLink table
PriceGroups=กลุ่มราคา
 ;Label for price group
PricePublishStatus=สถานะการเผยแพร่
PriceTrees=ผังราคา
 ;Label for price trees
PricingRuleApplicabilities=ค่าคุณลักษณะราคา
 ;Label for pricing rule applicability
PricingRuleApplicabilityLookupReference=ข้อมูลอ้างอิงการใช้งานกฎการกำหนดราคา
 ;Label for pricing rule applicability references
PricingStructure=โครงสร้างการกำหนดราคา
Product=ผลิตภัณฑ์
 ;Label for product attribute.
ProductDiscount=ส่วนลดสำหรับผลิตภัณฑ์
 ;Label for discount component
ProductDiscountAttributes=คุณลักษณะราคาของส่วนลดสำหรับผลิตภัณฑ์
Published=เผยแพร่แล้ว
Publishing=การเผยแพร่
Rank=อันดับ
 ;Priority for price rules.
Rebate=เงินคืน
 ;Label for rebate component
Revert=แปลงกลับ
SalesAgreement=ข้อตกลงการขาย
SalesOrderHeader=ส่วนหัวของใบสั่งขาย
 ;Label for sales order header attribute.
SalesOrderLine=รายการใบสั่งขาย
 ;Label for sales order line attribute.
SalesTradeAgreement=ข้อตกลงทางการค้าสำหรับการขาย
 ;Label for trade agreement component
ShippingDiscount=ส่วนลดการจัดส่งสินค้า
ShippingDiscountAttributes=คุณลักษณะราคาของส่วนลดสำหรับการจัดส่ง
TenderDiscount=ส่วนลดในการชำระเงิน
TenderDiscountAttributes=คุณลักษณะราคาของส่วนลดในการชำระเงิน
TradeAgreementAttributes=คุณลักษณะราคาของข้อตกลงทางการค้า
 ;Price attributes for trade agreements
UnifiedPricingFeatureLabel=(ไม่สมบูรณ์) การจัดการการกำหนดราคา
 ;Feature name for unified pricing management
UnifiedPricingFeatureSummary=โมดูลการจัดการการกำหนดราคาเป็นแพลตฟอร์มแบบรวมศูนย์สำหรับผู้จัดการการกำหนดราคาเพื่อวางแผน กำหนดค่า จัดการ จำลอง และตรวจสอบกลยุทธ์การกำหนดราคาผ่านช่องทาง Omni เมื่อเปิดใช้งานคุณลักษณะนี้ องค์กรสามารถตั้งค่าโครงสร้างการกำหนดราคาที่ยืดหยุ่นได้โดยใช้ส่วนประกอบราคาหลายรายการ เช่น ราคาพื้นฐานทั่วไป ข้อเสนอระยะยาว โปรโมชั่นระยะสั้น และเงินคืนย้อนหลัง สามารถกำหนดกฎการกำหนดราคาได้ตามคุณลักษณะของผลิตภัณฑ์ ลูกค้า และใบสั่ง การกำหนดราคาตามบริบทสามารถนำไปใช้กับเซ็กเมนต์ต่างๆ ตามเงื่อนไขที่กำหนดไว้ล่วงหน้า การคำนวณราคาแบบเรียลไทม์ขับเคลื่อนโดยเครื่องมือการกำหนดราคาแบบรวมที่ทำงานอย่างสม่ำเสมอทั่วทั้งกระบวนการทางธุรกิจในห่วงโซ่อุปทาน การค้าปลีก และอีคอมเมิร์ซ
 ;Feature summary for unified pricing management
