Added=已新增
AttributeWithComponentCode=當價格屬性連結到組件代碼時，您無法刪除。
AutoCharge=自動收費
 ;Label for charge component
BasePrice=基準價格
CalculationSequence=定價順序
 ;Label for pricing calculation sequence
CannotDeleteDefaultTree=預設價格樹無法刪除。
CannotInsertPriceTree=只允許使用一種價格樹。
Channel=管道
 ;Label for channel attribute.
ConcurrencyMode=並行處理模式
Customer=客戶
 ;Label for customer attribute.
DefaultPriceTree=預設價格樹
 ;Label for default price tree
Deleted=已刪除
DeletePriceAttribute=您將會刪除價格屬性中的一筆記錄。要刪除記錄嗎?
Discount=折扣
 ;Label for discount component
Draft=草稿
Fields=欄位
MaxAttributeNumber=您無法為價格元件定義超過 %1 屬性。
MoveDown=下移
MoveUp=上移
PostingProfileName=過帳設定檔
 ;Label for posting profile name
PriceAdjustment=價格調整
 ;Label for price adjustment component
PriceAdjustmentAttributes=價格調整的價格屬性
 ;Label for price adjustment attributes
PriceAttrbuteSource=來源
 ;Label for the source of price attributes
PriceAttribute=價格屬性
PriceAttributeCatalog=目錄
PriceAttributeColor=顏色
PriceAttributeConfiguration=設定
PriceAttributeCustAccountNum=客戶帳戶
PriceAttributeCustGroup=客戶群組
PriceAttributeCustMarkupGroup=客戶費用群組
PriceAttributeCustSegment=區段
PriceAttributeCustType=客戶類型
PriceAttributeDataType=價格屬性資料類型
 ;It's not public facing.
PriceAttributeDlvMode=交貨模式
PriceAttributeDlvModeMarkupGroup=運送費用群組
PriceAttributeItemMarkupGroup=品項費用群組
PriceAttributeName=姓名
 ;Label for the name of price attributes
PriceAttributeProcessStatus=處理狀態
 ;Label for price attribute process status
PriceAttributeProduct=產品
PriceAttributeProductCategory=類別
PriceAttributeProductVariant=產品變型
PriceAttributeProviderNotFound=找不到的價格屬性提供者 %1。
 ;An error indicating customization is not correct.
PriceAttributeProviderNotSupported=提供者 %1 不支持價格屬性 %2。
 ;An error indicating customization is not correct.
PriceAttributePublish=已成功發行價格屬性。
PriceAttributeRetailAffiliation=隸屬關係
PriceAttributeRetailLoyaltyTier=酬賓方案
PriceAttributes=價格屬性
 ;Label for price attributes form
PriceAttributeSite=地點
PriceAttributeSize=尺寸
PriceAttributeStatus=價格屬性狀態
 ;It's not public facing.
PriceAttributeStyle=樣式
PriceAttributeType=類型
 ;Label for price attribute types
PriceAttributeTypeCustomFields=自訂欄位
 ;Label for customization pricing attributes
PriceAttributeTypeEcoResAttribute=使用者定義的屬性
 ;Type of an attribute references EcoResAttribute
PriceAttributeTypePredefinedFields=預先定義的欄位
 ;Type of a predefined attribute field
PriceAttributeWarehouse=倉儲
PriceComponent=價格元件
 ;Label for price component
PriceComponentCodeCurrencyMode=並行處理模式
 ;Label for price component code concurrency mode
PriceComponentCodeName=價格元件代碼
 ;Label for price component code name
PriceComponentCodes=價格元件代碼
 ;Label for price component codes form
PriceGroupAttributes=價格群組的價格屬性
 ;Price attributes for price groups
PriceGroupPricingRuleLink=價格群組與定價規則之間的關聯
 ;Label for PriceGroupPricingRuleLink table
PriceGroups=價格群組
 ;Label for price group
PricePublishStatus=發佈狀態
PriceTrees=價格樹狀結構
 ;Label for price trees
PricingRuleApplicabilities=價格屬性值
 ;Label for pricing rule applicability
PricingRuleApplicabilityLookupReference=定價規則適用性參考
 ;Label for pricing rule applicability references
PricingStructure=定價結構
Product=產品
 ;Label for product attribute.
ProductDiscount=產品折扣
 ;Label for discount component
ProductDiscountAttributes=商品折扣的價格屬性
Published=已發佈
Publishing=出版
Rank=排名
 ;Priority for price rules.
Rebate=回扣
 ;Label for rebate component
Revert=還原
SalesAgreement=銷售協議
SalesOrderHeader=銷售訂單標頭
 ;Label for sales order header attribute.
SalesOrderLine=銷售訂單明細
 ;Label for sales order line attribute.
SalesTradeAgreement=銷售貿易協議
 ;Label for trade agreement component
ShippingDiscount=運送折扣
ShippingDiscountAttributes=運送折扣的價格屬性
TenderDiscount=投標折扣
TenderDiscountAttributes=投標折扣的價格屬性
TradeAgreementAttributes=貿易協定的價格屬性
 ;Price attributes for trade agreements
UnifiedPricingFeatureLabel=(不完整) 定價管理
 ;Feature name for unified pricing management
UnifiedPricingFeatureSummary=定價管理模組為定價經理提供一個集中的平台，可規劃、設定、管理、模擬和監控全通路定價策略。若啟用此功能，組織即可使用多種價格元件 (例如一般基準價格、長期交易、短期促銷和追溯性回饋金) 來設定靈活的定價結構。定價規則可以根據產品、客戶和訂單屬性加以定義。關聯式定價可根據預先定義的條件推出到不同的區段。即時定價計算是由整合的定價引擎提供，該引擎可在供應鏈、零售和電子商務的商務程序中一致運作。
 ;Feature summary for unified pricing management
