Added=Agregado
AttributeWithComponentCode=No puede eliminar un atributo de precio si está vinculado a un código de componente.
AutoCharge=Cargo automático
 ;Label for charge component
BasePrice=Precio base
CalculationSequence=Secuencia de precios
 ;Label for pricing calculation sequence
CannotDeleteDefaultTree=No se puede eliminar el árbol de precios predeterminado.
CannotInsertPriceTree=Solo se permite un árbol de precios.
Channel=Canal
 ;Label for channel attribute.
ConcurrencyMode=Modo de simultaneidad
Customer=Cliente
 ;Label for customer attribute.
DefaultPriceTree=Árbol de precios predeterminado
 ;Label for default price tree
Deleted=Eliminado
DeletePriceAttribute=Está a punto de eliminar un registro en atributos de precio. ¿Desea eliminar el registro?
Discount=Descuento
 ;Label for discount component
Draft=Borrador
Fields=Campos
MaxAttributeNumber=No puede definir más de %1 atributos para un componente de precio.
MoveDown=Mover abajo
MoveUp=Mover arriba
PostingProfileName=Perfil de registro
 ;Label for posting profile name
PriceAdjustment=Ajuste de precios
 ;Label for price adjustment component
PriceAdjustmentAttributes=Atributos de precio para ajustes de precio
 ;Label for price adjustment attributes
PriceAttrbuteSource=Origen
 ;Label for the source of price attributes
PriceAttribute=Atributo de precio
PriceAttributeCatalog=Catálogo
PriceAttributeColor=Color
PriceAttributeConfiguration=Configuración
PriceAttributeCustAccountNum=Cuenta de cliente
PriceAttributeCustGroup=Grupo de clientes
PriceAttributeCustMarkupGroup=Grupo de cargos de cliente
PriceAttributeCustSegment=Segmento
PriceAttributeCustType=Tipo de cliente
PriceAttributeDataType=Tipo de fecha de atributos de precio
 ;It's not public facing.
PriceAttributeDlvMode=Modo de entrega
PriceAttributeDlvModeMarkupGroup=Grupo de cargos de entrega
PriceAttributeItemMarkupGroup=Grupo de cargos de artículo
PriceAttributeName=Nombre
 ;Label for the name of price attributes
PriceAttributeProcessStatus=Estado de proceso
 ;Label for price attribute process status
PriceAttributeProduct=Producto
PriceAttributeProductCategory=Categoría
PriceAttributeProductVariant=Variante del producto
PriceAttributeProviderNotFound=No se encuentra ningún proveedor de atributos de precios para %1.
 ;An error indicating customization is not correct.
PriceAttributeProviderNotSupported=El proveedor %1 no admite el atributo de precio %2.
 ;An error indicating customization is not correct.
PriceAttributePublish=Los atributos de precio se han publicado correctamente.
PriceAttributeRetailAffiliation=Afiliación
PriceAttributeRetailLoyaltyTier=Programa de fidelización
PriceAttributes=Atributos de precio
 ;Label for price attributes form
PriceAttributeSite=Sitio
PriceAttributeSize=Tamaño
PriceAttributeStatus=Estado de atributo de precio
 ;It's not public facing.
PriceAttributeStyle=Estilo
PriceAttributeType=Tipo
 ;Label for price attribute types
PriceAttributeTypeCustomFields=Campos personalizados
 ;Label for customization pricing attributes
PriceAttributeTypeEcoResAttribute=Atributos definidos por el usuario
 ;Type of an attribute references EcoResAttribute
PriceAttributeTypePredefinedFields=Campos predefinidos
 ;Type of a predefined attribute field
PriceAttributeWarehouse=Almacén
PriceComponent=Componente de precio
 ;Label for price component
PriceComponentCodeCurrencyMode=Modo de simultaneidad
 ;Label for price component code concurrency mode
PriceComponentCodeName=Código de componente de precio
 ;Label for price component code name
PriceComponentCodes=Códigos de componente de precio
 ;Label for price component codes form
PriceGroupAttributes=Atributos de precio para grupos de precios
 ;Price attributes for price groups
PriceGroupPricingRuleLink=Vinculación entre el grupo de precios y la regla de precios
 ;Label for PriceGroupPricingRuleLink table
PriceGroups=Grupos de precios
 ;Label for price group
PricePublishStatus=Estado de publicación
PriceTrees=Árboles de precios
 ;Label for price trees
PricingRuleApplicabilities=Valores de atributo de precio
 ;Label for pricing rule applicability
PricingRuleApplicabilityLookupReference=Referencias de aplicabilidad de reglas de precios
 ;Label for pricing rule applicability references
PricingStructure=Estructura de precios
Product=Producto
 ;Label for product attribute.
ProductDiscount=Descuento de productos
 ;Label for discount component
ProductDiscountAttributes=Atributos de precio para descuentos de producto
Published=Publicada
Publishing=Publicación
Rank=Categoría
 ;Priority for price rules.
Rebate=Devolución
 ;Label for rebate component
Revert=Revertir
SalesAgreement=Acuerdo de venta
SalesOrderHeader=Encabezado de orden de venta
 ;Label for sales order header attribute.
SalesOrderLine=Línea de orden de venta
 ;Label for sales order line attribute.
SalesTradeAgreement=Contrato comercial de venta
 ;Label for trade agreement component
ShippingDiscount=Descuento por envío
ShippingDiscountAttributes=Atributos de precio para descuentos de envío
TenderDiscount=Descuento por forma de pago
TenderDiscountAttributes=Atributos de precio para descuentos por forma de pago
TradeAgreementAttributes=Atributos de precio para acuerdos comerciales
 ;Price attributes for trade agreements
UnifiedPricingFeatureLabel=(Incompleto) Administración de precios
 ;Feature name for unified pricing management
UnifiedPricingFeatureSummary=El módulo Administración de precios proporciona una plataforma centralizada en la que los administradores de precios planean, configuran, administran, simulan y supervisan las estrategias de precios omnicanal. Cuando esta característica está habilitada, las organizaciones pueden configurar estructuras de precios flexibles mediante varios componentes de precios, como precios base generales, acuerdos a largo plazo, promociones a corto plazo y devoluciones retroactivas. Se pueden definir reglas de precios según los atributos de producto, cliente y orden. Se pueden implementar precios contextuales en distintos segmentos de acuerdo con condiciones predefinidas. El cálculo de precios en tiempo real utiliza un motor de precios unificado que funciona de forma coherente en los procesos de negocio de la cadena de suministro, la venta minorista y el comercio electrónico.
 ;Feature summary for unified pricing management
