Added=مضاف
AttributeWithComponentCode=لا يمكنك حذف سمة سعر عندما تكون مرتبطة برمز مكون.
AutoCharge=التكلفة التلقائية
 ;Label for charge component
BasePrice=السعر الأساسي
CalculationSequence=تسلسل الأسعار
 ;Label for pricing calculation sequence
CannotDeleteDefaultTree=لا يمكن حذف شجرة الأسعار الافتراضية.
CannotInsertPriceTree=يُسمح بشجرة أسعار واحدة فقط.
Channel=القناة
 ;Label for channel attribute.
ConcurrencyMode=وضع التزامن
Customer=العميل
 ;Label for customer attribute.
DefaultPriceTree=شجرة الأسعار الافتراضية
 ;Label for default price tree
Deleted=محذوف
DeletePriceAttribute=أنت على وشك حذف سجل في سمات الأسعار. هل ترغب في حذف السجل؟
Discount=الخصم
 ;Label for discount component
Draft=المسودة
Fields=الحقول
MaxAttributeNumber=لا يمكنك تحديد أكثر من %1 من السمات لمكون السعر.
MoveDown=تحريك لأسفل
MoveUp=تحريك لأعلى
PostingProfileName=ملف تعريف الترحيل
 ;Label for posting profile name
PriceAdjustment=تعديل السعر
 ;Label for price adjustment component
PriceAdjustmentAttributes=سمات الأسعار لتعديلات الأسعار
 ;Label for price adjustment attributes
PriceAttrbuteSource=المصدر
 ;Label for the source of price attributes
PriceAttribute=سمة السعر
PriceAttributeCatalog=الكتالوج
PriceAttributeColor=اللون
PriceAttributeConfiguration=التكوين
PriceAttributeCustAccountNum=حساب العميل
PriceAttributeCustGroup=مجموعة العملاء
PriceAttributeCustMarkupGroup=مجموعة تكاليف العملاء
PriceAttributeCustSegment=الشريحة
PriceAttributeCustType=نوع العميل
PriceAttributeDataType=نوع بيانات سمة السعر
 ;It's not public facing.
PriceAttributeDlvMode=وضع التسليم
PriceAttributeDlvModeMarkupGroup=مجموعة تكاليف التسليم
PriceAttributeItemMarkupGroup=مجموعة تكاليف الأصناف
PriceAttributeName=الاسم
 ;Label for the name of price attributes
PriceAttributeProcessStatus=حالة العملية
 ;Label for price attribute process status
PriceAttributeProduct=المنتج
PriceAttributeProductCategory=‏‏الفئة‬
PriceAttributeProductVariant=متغير المنتج
PriceAttributeProviderNotFound=لم يتم العثور على موفر سمة السعر لـ %1.
 ;An error indicating customization is not correct.
PriceAttributeProviderNotSupported=لا يدعم الموفر %1 سمة السعر %2.
 ;An error indicating customization is not correct.
PriceAttributePublish=تم نشر سمات الأسعار بنجاح.
PriceAttributeRetailAffiliation=اقتران
PriceAttributeRetailLoyaltyTier=برنامج الولاء
PriceAttributes=سمات الأسعار
 ;Label for price attributes form
PriceAttributeSite=الموقع
PriceAttributeSize=الحجم
PriceAttributeStatus=حالة سمة السعر
 ;It's not public facing.
PriceAttributeStyle=النمط
PriceAttributeType=النوع
 ;Label for price attribute types
PriceAttributeTypeCustomFields=الحقول المخصصة
 ;Label for customization pricing attributes
PriceAttributeTypeEcoResAttribute=السمات المعرّفة بواسطة المستخدم
 ;Type of an attribute references EcoResAttribute
PriceAttributeTypePredefinedFields=الحقول المعرّفة مسبقًا
 ;Type of a predefined attribute field
PriceAttributeWarehouse=المستودع
PriceComponent=مكون السعر
 ;Label for price component
PriceComponentCodeCurrencyMode=وضع التزامن
 ;Label for price component code concurrency mode
PriceComponentCodeName=رمز مكون السعر
 ;Label for price component code name
PriceComponentCodes=رموز مكونات الأسعار
 ;Label for price component codes form
PriceGroupAttributes=سمات الأسعار لمجموعات الأسعار
 ;Price attributes for price groups
PriceGroupPricingRuleLink=الربط بين مجموعة الأسعار وقاعدة التسعير
 ;Label for PriceGroupPricingRuleLink table
PriceGroups=مجموعات الأسعار
 ;Label for price group
PricePublishStatus=حالة النشر
PriceTrees=أشجار الأسعار
 ;Label for price trees
PricingRuleApplicabilities=قيم سمات الأسعار
 ;Label for pricing rule applicability
PricingRuleApplicabilityLookupReference=مراجع قابلية تطبيق قاعدة التسعير
 ;Label for pricing rule applicability references
PricingStructure=بنية التسعير
Product=المنتج
 ;Label for product attribute.
ProductDiscount=خصم المنتج
 ;Label for discount component
ProductDiscountAttributes=سمات الأسعار لخصومات المنتج
Published=منشور
Publishing=النشر
Rank=رتبة
 ;Priority for price rules.
Rebate=خصم
 ;Label for rebate component
Revert=إرجاع
SalesAgreement=اتفاقية البيع
SalesOrderHeader=رأس أمر المبيعات
 ;Label for sales order header attribute.
SalesOrderLine=بند أمر المبيعات
 ;Label for sales order line attribute.
SalesTradeAgreement=اتفاقية البيع التجاري
 ;Label for trade agreement component
ShippingDiscount=خصم الشحن
ShippingDiscountAttributes=سمات الأسعار لخصومات الشحن
TenderDiscount=خصم على العرض
TenderDiscountAttributes=سمات الأسعار للخصومات على العرض
TradeAgreementAttributes=سمات الأسعار للاتفاقيات التجارية
 ;Price attributes for trade agreements
UnifiedPricingFeatureLabel=(غير مكتملة) إدارة التسعير‬
 ;Feature name for unified pricing management
UnifiedPricingFeatureSummary=توفر وحدة إدارة التسعير نظامًا أساسيًا مركزيًا لمديري التسعير لتخطيط استراتيجيات التسعير في القناة متعددة الاتجاهات وتكوينها وإدارتها ومحاكاتها ومراقبتها. مع تمكين هذه الميزة، يمكن للمؤسسات إعداد هياكل تسعير مرنة باستخدام مكونات أسعار متعددة مثل الأسعار الأساسية العامة والصفقات طويلة الأجل والعروض الترويجية قصيرة الأجل والخصومات بأثر رجعي. يمكن تحديد قواعد التسعير بناء على سمات المنتج والعميل والأمر. يمكن نشر التسعير السياقي في شرائح مختلفة بناء على شروط معرّفة مسبقًا. يتم تشغيل حساب التسعير في الوقت الحقيقي بواسطة محرك تسعير موحّد يعمل باستمرار عبر سلسلة التوريد وتجارة التجزئة ودورات عمل التجارة الإلكترونية.
 ;Feature summary for unified pricing management
