Added=追加済
AttributeWithComponentCode=コンポーネント コードにリンクされている価格属性は削除できません。
AutoCharge=自動請求
 ;Label for charge component
BasePrice=基準価格
CalculationSequence=価格順序
 ;Label for pricing calculation sequence
CannotDeleteDefaultTree=既定の価格ツリーは削除できません。
CannotInsertPriceTree=価格ツリーは 1 つしか許可されません。
Channel=チャネル
 ;Label for channel attribute.
ConcurrencyMode=同時実行モード
Customer=顧客
 ;Label for customer attribute.
DefaultPriceTree=既定の価格ツリー
 ;Label for default price tree
Deleted=削除済
DeletePriceAttribute=価格属性のレコードを削除しようとしています。レコードを削除しますか?
Discount=割引
 ;Label for discount component
Draft=ドラフト
Fields=フィールド
MaxAttributeNumber=価格コンポーネントに %1 件よりも多くの属性を定義することはできません。
MoveDown=下へ移動
MoveUp=上へ移動
PostingProfileName=転記プロファイル
 ;Label for posting profile name
PriceAdjustment=価格調整
 ;Label for price adjustment component
PriceAdjustmentAttributes=価格調整の価格属性
 ;Label for price adjustment attributes
PriceAttrbuteSource=ソース
 ;Label for the source of price attributes
PriceAttribute=価格属性
PriceAttributeCatalog=カタログ
PriceAttributeColor=色
PriceAttributeConfiguration=構成
PriceAttributeCustAccountNum=顧客アカウント
PriceAttributeCustGroup=顧客グループ
PriceAttributeCustMarkupGroup=顧客の諸費用グループ
PriceAttributeCustSegment=セグメント
PriceAttributeCustType=顧客タイプ
PriceAttributeDataType=価格属性データ タイプ
 ;It's not public facing.
PriceAttributeDlvMode=配送方法
PriceAttributeDlvModeMarkupGroup=配送の諸費用グループ
PriceAttributeItemMarkupGroup=品目の諸費用グループ
PriceAttributeName=名前
 ;Label for the name of price attributes
PriceAttributeProcessStatus=プロセスの状態
 ;Label for price attribute process status
PriceAttributeProduct=製品
PriceAttributeProductCategory=カテゴリ
PriceAttributeProductVariant=製品バリアント
PriceAttributeProviderNotFound=%1 に価格属性プロバイダーが見つかりません。
 ;An error indicating customization is not correct.
PriceAttributeProviderNotSupported=プロバイダー %1 が価格属性 %2 をサポートしていません。
 ;An error indicating customization is not correct.
PriceAttributePublish=価格属性が正常に公開されました。
PriceAttributeRetailAffiliation=所属
PriceAttributeRetailLoyaltyTier=ロイヤルティ プログラム
PriceAttributes=価格属性
 ;Label for price attributes form
PriceAttributeSite=サイト
PriceAttributeSize=サイズ
PriceAttributeStatus=価格属性の状態
 ;It's not public facing.
PriceAttributeStyle=スタイル
PriceAttributeType=タイプ
 ;Label for price attribute types
PriceAttributeTypeCustomFields=カスタム フィールド
 ;Label for customization pricing attributes
PriceAttributeTypeEcoResAttribute=ユーザー定義属性
 ;Type of an attribute references EcoResAttribute
PriceAttributeTypePredefinedFields=事前定義フィールド
 ;Type of a predefined attribute field
PriceAttributeWarehouse=倉庫
PriceComponent=価格コンポーネント
 ;Label for price component
PriceComponentCodeCurrencyMode=同時実行モード
 ;Label for price component code concurrency mode
PriceComponentCodeName=価格コンポーネント コード
 ;Label for price component code name
PriceComponentCodes=価格コンポーネント コード
 ;Label for price component codes form
PriceGroupAttributes=価格グループの価格属性
 ;Price attributes for price groups
PriceGroupPricingRuleLink=価格グループと価格決定ルールの間のリンク
 ;Label for PriceGroupPricingRuleLink table
PriceGroups=価格グループ
 ;Label for price group
PricePublishStatus=公開状態
PriceTrees=価格ツリー
 ;Label for price trees
PricingRuleApplicabilities=価格属性値
 ;Label for pricing rule applicability
PricingRuleApplicabilityLookupReference=価格決定ルール適用性参照
 ;Label for pricing rule applicability references
PricingStructure=価格構造
Product=製品
 ;Label for product attribute.
ProductDiscount=製品割引
 ;Label for discount component
ProductDiscountAttributes=製品割引の価格属性
Published=公開済
Publishing=公開しています
Rank=ランク
 ;Priority for price rules.
Rebate=リベート
 ;Label for rebate component
Revert=元に戻す
SalesAgreement=販売契約書
SalesOrderHeader=販売注文ヘッダー
 ;Label for sales order header attribute.
SalesOrderLine=販売注文明細行
 ;Label for sales order line attribute.
SalesTradeAgreement=販売取引契約
 ;Label for trade agreement component
ShippingDiscount=出荷割引
ShippingDiscountAttributes=出荷割引の価格属性
TenderDiscount=支払/入金割引
TenderDiscountAttributes=業者割引の価格属性
TradeAgreementAttributes=売買契約の価格属性
 ;Price attributes for trade agreements
UnifiedPricingFeatureLabel=(不完全) 価格決定管理
 ;Feature name for unified pricing management
UnifiedPricingFeatureSummary=価格決定管理モジュールには、価格決定マネージャーがオムニチャネル価格決定戦略を計画、構成、管理、シミュレーション、監視するための一元的なプラットフォームが用意されています。この機能を有効にすると、組織は、一般基準価格、長期取引、短期プロモーション、遡及リベートなどの複数の価格コンポーネントを使用して、柔軟な価格決定構造を設定できます。価格決定ルールは、製品、顧客、注文属性に基づいて定義できます。事前定義された条件に基づいて、コンテキストに応じた価格決定をさまざまなセグメントに展開できます。リアルタイム価格決定計算では、サプライ チェーン、小売、および eコマース ビジネス プロセスにまたがって機能する統合価格決定エンジンが利用されます。
 ;Feature summary for unified pricing management
