Added=Hinzugefügt
AttributeWithComponentCode=Sie können ein Preisattribut nicht löschen, wenn es mit einem Komponentencode verknüpft ist.
AutoCharge=Automatisch belasten
 ;Label for charge component
BasePrice=Basispreis
CalculationSequence=Preisfolge
 ;Label for pricing calculation sequence
CannotDeleteDefaultTree=Die Standardpreisstruktur kann nicht gelöscht werden.
CannotInsertPriceTree=Es ist nur eine Preisstruktur zulässig.
Channel=Kanal
 ;Label for channel attribute.
ConcurrencyMode=Konfliktmodus
Customer=Debitor
 ;Label for customer attribute.
DefaultPriceTree=Standardpreisstruktur
 ;Label for default price tree
Deleted=Gelöscht
DeletePriceAttribute=Sie sind dabei, einen Datensatz in den Preisattributen zu löschen. Datensatz löschen?
Discount=Rabatt
 ;Label for discount component
Draft=Entwurf
Fields=Felder
MaxAttributeNumber=Sie können nur %1 Attribute für eine Preiskomponente definieren.
MoveDown=Nach unten verschieben
MoveUp=Nach oben verschieben
PostingProfileName=Buchungsprofil
 ;Label for posting profile name
PriceAdjustment=Preisregulierung
 ;Label for price adjustment component
PriceAdjustmentAttributes=Preisattribute für Preisregulierungen
 ;Label for price adjustment attributes
PriceAttrbuteSource=Quelle
 ;Label for the source of price attributes
PriceAttribute=Preisattribut
PriceAttributeCatalog=Katalog
PriceAttributeColor=Farbe
PriceAttributeConfiguration=Konfiguration
PriceAttributeCustAccountNum=Debitorenkonto
PriceAttributeCustGroup=Debitorengruppe
PriceAttributeCustMarkupGroup=Gruppe für Debitorenbelastungen
PriceAttributeCustSegment=Segment
PriceAttributeCustType=Debitorentyp
PriceAttributeDataType=Datentyp des Preisattributs
 ;It's not public facing.
PriceAttributeDlvMode=Lieferart
PriceAttributeDlvModeMarkupGroup=Gruppe für Lieferbelastung
PriceAttributeItemMarkupGroup=Gruppe für Artikelbelastung
PriceAttributeName=Name
 ;Label for the name of price attributes
PriceAttributeProcessStatus=Prozessstatus
 ;Label for price attribute process status
PriceAttributeProduct=Produkt
PriceAttributeProductCategory=Kategorie
PriceAttributeProductVariant=Produktvariante
PriceAttributeProviderNotFound=Es wurde kein Preisattributanbieter für %1 gefunden.
 ;An error indicating customization is not correct.
PriceAttributeProviderNotSupported=Anbieter %1 unterstützt nicht das Preisattribut %2.
 ;An error indicating customization is not correct.
PriceAttributePublish=Preisattribute wurden erfolgreich veröffentlicht.
PriceAttributeRetailAffiliation=Zugehörigkeit
PriceAttributeRetailLoyaltyTier=Treueprogramm
PriceAttributes=Preisattribute
 ;Label for price attributes form
PriceAttributeSite=Standort
PriceAttributeSize=Größe
PriceAttributeStatus=Preisattributstatus
 ;It's not public facing.
PriceAttributeStyle=Format
PriceAttributeType=Typ
 ;Label for price attribute types
PriceAttributeTypeCustomFields=Benutzerdefinierte Felder
 ;Label for customization pricing attributes
PriceAttributeTypeEcoResAttribute=Vom Benutzer definierte Attribute
 ;Type of an attribute references EcoResAttribute
PriceAttributeTypePredefinedFields=Vordefinierte Felder
 ;Type of a predefined attribute field
PriceAttributeWarehouse=Lagerort
PriceComponent=Preiskomponente
 ;Label for price component
PriceComponentCodeCurrencyMode=Konfliktmodus
 ;Label for price component code concurrency mode
PriceComponentCodeName=Preiskomponentencode
 ;Label for price component code name
PriceComponentCodes=Preiskomponentencodes
 ;Label for price component codes form
PriceGroupAttributes=Preisattribute für Preisgruppen
 ;Price attributes for price groups
PriceGroupPricingRuleLink=Verknüpfung zwischen Preisgruppe und Preisgestaltungsregel
 ;Label for PriceGroupPricingRuleLink table
PriceGroups=Preisgruppen
 ;Label for price group
PricePublishStatus=Veröffentlichungsstatus
PriceTrees=Preisstrukturen
 ;Label for price trees
PricingRuleApplicabilities=Preisattributwerte
 ;Label for pricing rule applicability
PricingRuleApplicabilityLookupReference=Referenzen für Anwendbarkeit der Preisgestaltungsregel
 ;Label for pricing rule applicability references
PricingStructure=Preisgestaltungsstruktur
Product=Produkt
 ;Label for product attribute.
ProductDiscount=Produktrabatt
 ;Label for discount component
ProductDiscountAttributes=Preisattribute für Produktrabatte
Published=Veröffentlicht
Publishing=Verlagswesen
Rank=Rang
 ;Priority for price rules.
Rebate=Rückvergütung
 ;Label for rebate component
Revert=Zurücksetzen
SalesAgreement=Kaufvertrag
SalesOrderHeader=Auftragskopf
 ;Label for sales order header attribute.
SalesOrderLine=Auftragsposition
 ;Label for sales order line attribute.
SalesTradeAgreement=Handelsvereinbarung (Verkauf)
 ;Label for trade agreement component
ShippingDiscount=Versandrabatt
ShippingDiscountAttributes=Preisattribute für Versandrabatte
TenderDiscount=Ausschreibungsrabatt
TenderDiscountAttributes=Preisattribute für Ausschreibungsrabatte
TradeAgreementAttributes=Preisattribute für Handelsvereinbarungen
 ;Price attributes for trade agreements
UnifiedPricingFeatureLabel=Preisgestaltungsverwaltung (unvollständig)
 ;Feature name for unified pricing management
UnifiedPricingFeatureSummary=Das Verwaltungsmodul für die Preisgestaltung bietet Preismanagern eine zentrale Plattform zum Planen, Konfigurieren, Verwalten, Simulieren und Überwachen von Omnichannel-Preisstrategien. Wenn diese Funktion aktiviert ist, können Organisationen flexible Preisstrukturen mithilfe mehrerer Preiskomponenten wie allgemeine Grundpreise, langfristige Angebote, kurzfristige Werbeaktionen und rückwirkende Rabatte einrichten. Preisregeln können basierend auf Produkt-, Debitoren- und Bestellattributen definiert werden. Die kontextbezogene Preisgestaltung kann basierend auf vordefinierten Bedingungen auf verschiedene Segmente ausgeweitet werden. Die Preisberechnung in Echtzeit wird von einem einheitlichen Preismodul unterstützt, das in allen Geschäftsprozessen der Lieferkette, des Einzelhandels und des E-Commerce konsistent funktioniert.
 ;Feature summary for unified pricing management
