Added=Добавлено
AttributeWithComponentCode=Невозможно удалить атрибут цены, если он связан с кодом компонента.
AutoCharge=Автоматически начислять
 ;Label for charge component
BasePrice=Базовая цена
CalculationSequence=Последовательность расчета цен
 ;Label for pricing calculation sequence
CannotDeleteDefaultTree=Невозможно удалить дерево цен по умолчанию.
CannotInsertPriceTree=Допускается только одно дерево цен.
Channel=Канал
 ;Label for channel attribute.
ConcurrencyMode=Режим параллелизма
Customer=Заказчик
 ;Label for customer attribute.
DefaultPriceTree=Дерево цен по умолчанию
 ;Label for default price tree
Deleted=Удален
DeletePriceAttribute=Запись в атрибутах цены будет удалена. Удалить запись?
Discount=Скидка
 ;Label for discount component
Draft=Черновик
Fields=Поля
MaxAttributeNumber=Нельзя определить больше %1 атрибутов для компонента цены.
MoveDown=Переместить вниз
MoveUp=Переместить вверх
PostingProfileName=Профиль разноски
 ;Label for posting profile name
PriceAdjustment=Ценовая коррекция
 ;Label for price adjustment component
PriceAdjustmentAttributes=Атрибуты цены для корректировок цен
 ;Label for price adjustment attributes
PriceAttrbuteSource=Источник
 ;Label for the source of price attributes
PriceAttribute=Атрибут цены
PriceAttributeCatalog=Каталог
PriceAttributeColor=Цвет
PriceAttributeConfiguration=Конфигурация
PriceAttributeCustAccountNum=Счет клиента
PriceAttributeCustGroup=Группа клиентов
PriceAttributeCustMarkupGroup=Группа накладных расходов по клиентам
PriceAttributeCustSegment=Сегмент
PriceAttributeCustType=Тип клиента
PriceAttributeDataType=Тип данных атрибута цены
 ;It's not public facing.
PriceAttributeDlvMode=Способ поставки
PriceAttributeDlvModeMarkupGroup=Группа расходов на поставку
PriceAttributeItemMarkupGroup=Группа расходов по номенклатурам
PriceAttributeName=Имя
 ;Label for the name of price attributes
PriceAttributeProcessStatus=Статус процесса
 ;Label for price attribute process status
PriceAttributeProduct=Продукт
PriceAttributeProductCategory=Категория
PriceAttributeProductVariant=Вариант продукта
PriceAttributeProviderNotFound=Не найден поставщик атрибутов цены для %1.
 ;An error indicating customization is not correct.
PriceAttributeProviderNotSupported=Поставщик %1 не поддерживает атрибут цены %2.
 ;An error indicating customization is not correct.
PriceAttributePublish=Атрибуты цены успешно опубликованы.
PriceAttributeRetailAffiliation=Найм/назначение
PriceAttributeRetailLoyaltyTier=Программа лояльности
PriceAttributes=Атрибуты цены
 ;Label for price attributes form
PriceAttributeSite=Сайт
PriceAttributeSize=Размер
PriceAttributeStatus=Статус атрибута цены
 ;It's not public facing.
PriceAttributeStyle=Стиль
PriceAttributeType=Тип
 ;Label for price attribute types
PriceAttributeTypeCustomFields=Пользовательские поля
 ;Label for customization pricing attributes
PriceAttributeTypeEcoResAttribute=Определяемые пользователем атрибуты
 ;Type of an attribute references EcoResAttribute
PriceAttributeTypePredefinedFields=Предопределенные поля
 ;Type of a predefined attribute field
PriceAttributeWarehouse=Склад
PriceComponent=Компонент цены
 ;Label for price component
PriceComponentCodeCurrencyMode=Режим параллелизма
 ;Label for price component code concurrency mode
PriceComponentCodeName=Код компонента цены
 ;Label for price component code name
PriceComponentCodes=Коды компонентов цены
 ;Label for price component codes form
PriceGroupAttributes=Атрибуты цены для групп цен
 ;Price attributes for price groups
PriceGroupPricingRuleLink=Связь между группой цен и правилом ценообразования
 ;Label for PriceGroupPricingRuleLink table
PriceGroups=Группы цен
 ;Label for price group
PricePublishStatus=Статус публикации
PriceTrees=Деревья цен
 ;Label for price trees
PricingRuleApplicabilities=Значения атрибутов цены
 ;Label for pricing rule applicability
PricingRuleApplicabilityLookupReference=Ссылки применимости правила ценообразования
 ;Label for pricing rule applicability references
PricingStructure=Структура ценообразования
Product=Продукт
 ;Label for product attribute.
ProductDiscount=Скидка для продукта
 ;Label for discount component
ProductDiscountAttributes=Атрибуты цены для скидок на продукты
Published=Опубликовано
Publishing=Издательское дело
Rank=Ранг
 ;Priority for price rules.
Rebate=Ретробонус
 ;Label for rebate component
Revert=Восстановить
SalesAgreement=Договор продажи
SalesOrderHeader=Заголовок заказа на продажу
 ;Label for sales order header attribute.
SalesOrderLine=Строка заказа на продажу
 ;Label for sales order line attribute.
SalesTradeAgreement=Коммерческое соглашение по продаже
 ;Label for trade agreement component
ShippingDiscount=Скидки при отгрузке
ShippingDiscountAttributes=Атрибуты цены для скидок при отгрузке
TenderDiscount=Скидка по платежному средству
TenderDiscountAttributes=Атрибуты цены для скидок по платежному средству
TradeAgreementAttributes=Атрибуты цены для коммерческих соглашений
 ;Price attributes for trade agreements
UnifiedPricingFeatureLabel=(Не завершено) Управление ценообразованием
 ;Feature name for unified pricing management
UnifiedPricingFeatureSummary=Модуль "Управление ценообразованием" предоставляет менеджерам по ценообразованию централизованную платформу для планирования, настройки, управления, моделирования и отслеживания многоканальных стратегий ценообразования. При включении этой функции организации могут настроить гибкие структуры ценообразования, используя несколько компонентов цен, таких как общие базовые цены, долгосрочные сделки, краткосрочные рекламные акции и ретробонусы. Правила ценообразования могут определяться на основе атрибутов продукта, клиента и заказа. Контекстное ценообразование может быть реализовано в различных сегментах в зависимости от заранее заданных условий. Расчет цен в реальном времени поддерживается унифицированным механизмом ценообразования, который стабильно работает по бизнес-процессам цепочек поставок, розничной торговли и электронной коммерции.
 ;Feature summary for unified pricing management
