Added=Adăugat
AttributeWithComponentCode=Nu puteți șterge un atribut al prețului atunci când este legat de un cod de componentă.
AutoCharge=Tarifare automată
 ;Label for charge component
BasePrice=Preț de bază
CalculationSequence=Secvență de prețuri
 ;Label for pricing calculation sequence
CannotDeleteDefaultTree=Arborele de prețuri implicit nu poate fi șters.
CannotInsertPriceTree=Este permis un singur arbore de prețuri.
Channel=Canal
 ;Label for channel attribute.
ConcurrencyMode=Mod concurență
Customer=Client
 ;Label for customer attribute.
DefaultPriceTree=Arbore de prețuri implicit
 ;Label for default price tree
Deleted=Șters
DeletePriceAttribute=Sunteți pe cale de a șterge o înregistrare din atributele prețului. Ștergeți înregistrarea?
Discount=Reducere
 ;Label for discount component
Draft=Schiță
Fields=Câmpuri
MaxAttributeNumber=Nu puteți defini mai mult de %1 atribute pentru o componentă de preț.
MoveDown=Mutare în jos
MoveUp=Mutare în sus
PostingProfileName=Profil de transcriere
 ;Label for posting profile name
PriceAdjustment=Ajustare de preț
 ;Label for price adjustment component
PriceAdjustmentAttributes=Atribute preț pentru ajustări de preț
 ;Label for price adjustment attributes
PriceAttrbuteSource=Sursă
 ;Label for the source of price attributes
PriceAttribute=Atribut preț
PriceAttributeCatalog=Catalog
PriceAttributeColor=Culoare
PriceAttributeConfiguration=Configurare
PriceAttributeCustAccountNum=Cont client
PriceAttributeCustGroup=Grup de clienți
PriceAttributeCustMarkupGroup=Grup de tarife clienți
PriceAttributeCustSegment=Segment
PriceAttributeCustType=Tip de client
PriceAttributeDataType=Tip de date atribute preț
 ;It's not public facing.
PriceAttributeDlvMode=Mod de livrare
PriceAttributeDlvModeMarkupGroup=Grup de tarife de livrare
PriceAttributeItemMarkupGroup=Grup de tarife articole
PriceAttributeName=Nume
 ;Label for the name of price attributes
PriceAttributeProcessStatus=Stare proces
 ;Label for price attribute process status
PriceAttributeProduct=Produs
PriceAttributeProductCategory=Categorie
PriceAttributeProductVariant=Variantă produs
PriceAttributeProviderNotFound=Nu a fost găsit niciun furnizor de atribute ale prețului pentru %1.
 ;An error indicating customization is not correct.
PriceAttributeProviderNotSupported=Furnizorul %1 nu acceptă atributul de preț %2.
 ;An error indicating customization is not correct.
PriceAttributePublish=Atributele prețului au fost publicate.
PriceAttributeRetailAffiliation=Afiliere
PriceAttributeRetailLoyaltyTier=Program de fidelitate
PriceAttributes=Atribute preț
 ;Label for price attributes form
PriceAttributeSite=Sediu
PriceAttributeSize=Dimensiune
PriceAttributeStatus=Stare atribute preț
 ;It's not public facing.
PriceAttributeStyle=Stil
PriceAttributeType=Tip
 ;Label for price attribute types
PriceAttributeTypeCustomFields=Câmpuri particularizate
 ;Label for customization pricing attributes
PriceAttributeTypeEcoResAttribute=Atribute definite de utilizator
 ;Type of an attribute references EcoResAttribute
PriceAttributeTypePredefinedFields=Câmpuri predefinite
 ;Type of a predefined attribute field
PriceAttributeWarehouse=Depozit
PriceComponent=Componentă preț
 ;Label for price component
PriceComponentCodeCurrencyMode=Mod concurență
 ;Label for price component code concurrency mode
PriceComponentCodeName=Cod componentă preț
 ;Label for price component code name
PriceComponentCodes=Coduri de componente de preț
 ;Label for price component codes form
PriceGroupAttributes=Atribute preț pentru grupuri de prețuri
 ;Price attributes for price groups
PriceGroupPricingRuleLink=Legătura dintre grupul de prețuri și regula de stabilire a prețurilor
 ;Label for PriceGroupPricingRuleLink table
PriceGroups=Grupuri de prețuri
 ;Label for price group
PricePublishStatus=Stare publicare
PriceTrees=Arbori de prețuri
 ;Label for price trees
PricingRuleApplicabilities=Valori atribute preț
 ;Label for pricing rule applicability
PricingRuleApplicabilityLookupReference=Referințe de aplicabilitate pentru regulile de stabilire a prețurilor
 ;Label for pricing rule applicability references
PricingStructure=Structură prețuri
Product=Produs
 ;Label for product attribute.
ProductDiscount=Reducere produs
 ;Label for discount component
ProductDiscountAttributes=Atribute preț pentru reduceri la produse
Published=Publicat
Publishing=Se publică
Rank=Clasificare
 ;Priority for price rules.
Rebate=Reducere
 ;Label for rebate component
Revert=Revenire
SalesAgreement=Contract de vânzări
SalesOrderHeader=Antet comandă de vânzare
 ;Label for sales order header attribute.
SalesOrderLine=Linie comandă de vânzare
 ;Label for sales order line attribute.
SalesTradeAgreement=Contract comercial de vânzări
 ;Label for trade agreement component
ShippingDiscount=Reducere expediere
ShippingDiscountAttributes=Atribute preț pentru reduceri la expediere
TenderDiscount=Reducere ofertă
TenderDiscountAttributes=Atribute preț pentru reduceri la oferte
TradeAgreementAttributes=Atribute preț pentru contracte comerciale
 ;Price attributes for trade agreements
UnifiedPricingFeatureLabel=(Incomplet) Gestionarea prețurilor
 ;Feature name for unified pricing management
UnifiedPricingFeatureSummary=Modulul Gestionarea prețurilor oferă o platformă centralizată pentru managerii de prețuri pentru a planifica, configura, gestiona, simula și monitoriza strategiile de prețuri omnicanal. Cu această caracteristică activată, organizațiile pot configura structuri de prețuri flexibile folosind mai multe componente de preț, cum ar fi prețurile de bază generale, ofertele pe termen lung, promoțiile pe termen scurt și reducerile retroactive. Regulile de stabilire a prețurilor pot fi definite pe baza atributelor produsului, clientului și comenzii. Prețurile contextuale pot fi implementate în diferite segmente în funcție de condiții predefinite. Calcularea prețurilor în timp real este alimentată de un motor unificat de stabilire a prețurilor care funcționează în mod constant în procesele de business ale lanțului de aprovizionare, retail și comerț electronic.
 ;Feature summary for unified pricing management
