Added=Lisatud
AttributeWithComponentCode=Te ei saa hinnaatribuuti kustutada, kui see on lingitud komponendi koodiga.
AutoCharge=Automaatne tasu
 ;Label for charge component
BasePrice=Baashind
CalculationSequence=Hinnakujunduse järjestus
 ;Label for pricing calculation sequence
CannotDeleteDefaultTree=Vaikehinnapuud ei saa kustutada.
CannotInsertPriceTree=Lubatud on ainult üks hinnapuu.
Channel=Kanal
 ;Label for channel attribute.
ConcurrencyMode=Samaaegsuse režiim
Customer=Klient
 ;Label for customer attribute.
DefaultPriceTree=Vaikehinnapuu
 ;Label for default price tree
Deleted=Kustutatud
DeletePriceAttribute=Olete kustutamas hinnaatribuutides olevat kirjet. Kas soovite kirje kustutada?
Discount=Allahindlus
 ;Label for discount component
Draft=Mustand
Fields=Väljad
MaxAttributeNumber=Ühe hinnakomponendi jaoks ei saa määratleda rohkem kui %1 atribuuti.
MoveDown=Nihuta alla
MoveUp=Nihuta üles
PostingProfileName=Sisestusprofiil
 ;Label for posting profile name
PriceAdjustment=Hinna korrigeerimine
 ;Label for price adjustment component
PriceAdjustmentAttributes=Hinna korrigeerimiste hinnaatribuudid
 ;Label for price adjustment attributes
PriceAttrbuteSource=Allikas
 ;Label for the source of price attributes
PriceAttribute=Hinnaatribuut
PriceAttributeCatalog=Kataloog
PriceAttributeColor=Värv
PriceAttributeConfiguration=Konfiguratsioon
PriceAttributeCustAccountNum=Kliendi konto
PriceAttributeCustGroup=Kliendigrupp
PriceAttributeCustMarkupGroup=Kliendi tasude grupp
PriceAttributeCustSegment=Segment
PriceAttributeCustType=Kliendi tüüp
PriceAttributeDataType=Hinnaatribuudi kuupäeva tüüp
 ;It's not public facing.
PriceAttributeDlvMode=Tarneviis
PriceAttributeDlvModeMarkupGroup=Tarne tasu grupp
PriceAttributeItemMarkupGroup=Kauba tasu grupp
PriceAttributeName=Nimi
 ;Label for the name of price attributes
PriceAttributeProcessStatus=Protsessi olek
 ;Label for price attribute process status
PriceAttributeProduct=Toode
PriceAttributeProductCategory=Kategooria
PriceAttributeProductVariant=Tootevariant
PriceAttributeProviderNotFound=%1 kohta ei leitud hinnaatribuudi pakkujat.
 ;An error indicating customization is not correct.
PriceAttributeProviderNotSupported=Pakkuja %1 ei toeta hinnaatribuuti %2.
 ;An error indicating customization is not correct.
PriceAttributePublish=Hinnaatribuudid on avaldatud.
PriceAttributeRetailAffiliation=Alluvus
PriceAttributeRetailLoyaltyTier=Püsikliendi programm
PriceAttributes=Hinnaatribuudid
 ;Label for price attributes form
PriceAttributeSite=Koht
PriceAttributeSize=Maht
PriceAttributeStatus=Hinnaatribuudi olek
 ;It's not public facing.
PriceAttributeStyle=Laad
PriceAttributeType=Tüüp
 ;Label for price attribute types
PriceAttributeTypeCustomFields=Kohandatud väljad
 ;Label for customization pricing attributes
PriceAttributeTypeEcoResAttribute=Kasutaja määratletud atribuudid
 ;Type of an attribute references EcoResAttribute
PriceAttributeTypePredefinedFields=Eelmääratletud väljad
 ;Type of a predefined attribute field
PriceAttributeWarehouse=Ladu
PriceComponent=Hinnakomponent
 ;Label for price component
PriceComponentCodeCurrencyMode=Samaaegsuse režiim
 ;Label for price component code concurrency mode
PriceComponentCodeName=Hinnakomponendi kood
 ;Label for price component code name
PriceComponentCodes=Hinnakomponendi koodid
 ;Label for price component codes form
PriceGroupAttributes=Hinnagruppide hinnaatribuudid
 ;Price attributes for price groups
PriceGroupPricingRuleLink=Seos hinnagrupi ja hinnakujundusreegli vahel
 ;Label for PriceGroupPricingRuleLink table
PriceGroups=Hinnagrupid
 ;Label for price group
PricePublishStatus=Avalda olek
PriceTrees=Hinnapuud
 ;Label for price trees
PricingRuleApplicabilities=Hinnaatribuudi väärtused
 ;Label for pricing rule applicability
PricingRuleApplicabilityLookupReference=Hinnakujundusreegli kohaldavuse viited
 ;Label for pricing rule applicability references
PricingStructure=Hinnakujunduse struktuur
Product=Toode
 ;Label for product attribute.
ProductDiscount=Toote allahindlus
 ;Label for discount component
ProductDiscountAttributes=Toote allahindluste hinnaatribuudid
Published=Avaldatud
Publishing=Kirjastamine
Rank=Reiting
 ;Priority for price rules.
Rebate=Tagasimakse
 ;Label for rebate component
Revert=Ennista
SalesAgreement=Müügileping
SalesOrderHeader=Müügitellimuse päis
 ;Label for sales order header attribute.
SalesOrderLine=Müügitellimuse rida
 ;Label for sales order line attribute.
SalesTradeAgreement=Müügi kaubanduslepe
 ;Label for trade agreement component
ShippingDiscount=Saatmise allahindlus
ShippingDiscountAttributes=Saatmise allahindluste hinnaatribuudid
TenderDiscount=Maksevahendipõhine allahindlus
TenderDiscountAttributes=Maksevahendipõhise allahindluste hinnaatribuudid
TradeAgreementAttributes=Kaubanduslepete hinnaatribuudid
 ;Price attributes for trade agreements
UnifiedPricingFeatureLabel=(Mittetäielik) Hinnakujunduse haldus
 ;Feature name for unified pricing management
UnifiedPricingFeatureSummary=Hinnakujunduse haldamise moodul pakub hinnakujunduse halduritele keskset platvormi omnikanalipõhise hinnakujunduse strateegiate plaanimiseks, konfigureerimiseks, haldamiseks, simuleerimiseks ja jälgimiseks. Kui see funktsioon on lubatud, saavad organisatsioonid häälestada paindlikke hinnakujunduse struktuure, kasutades mitut hinnakomponenti (nt üldised baashinnad, pikaajalised tehingud, lühiajalised kampaaniad ja tagasiulatuvad allahindlused). Hinnakujundusreeglid saab määratleda toote, kliendi ja tellimuse atribuutide põhjal. Kontekstipõhise hinnakujunduse saab eelmääratletud tingimuste alusel kasutusele võtta eri segmentides. Reaalajas hinnakujunduse arvutamine põhineb ühtsel hinnakujunduse mootoril, mis töötab järjepidevalt kõigis tarneahela, jaemüügi ja e-kaubanduse äriprotsessides.
 ;Feature summary for unified pricing management
