Added=Adicionados
AttributeWithComponentCode=Não é possível eliminar um atributo de preço quando o mesmo está associado a um código de componente.
AutoCharge=Encargo automático
 ;Label for charge component
BasePrice=Preço base
CalculationSequence=Sequência de preços
 ;Label for pricing calculation sequence
CannotDeleteDefaultTree=Não é possível eliminar a árvore de preços predefinida.
CannotInsertPriceTree=Só é permitida uma árvore de preços.
Channel=Canal
 ;Label for channel attribute.
ConcurrencyMode=Modo de simultaneidade
Customer=Cliente
 ;Label for customer attribute.
DefaultPriceTree=Árvore de preços predefinida
 ;Label for default price tree
Deleted=Eliminada
DeletePriceAttribute=Está prestes a eliminar um registo nos atributos de preço. Eliminar o registo?
Discount=Desconto
 ;Label for discount component
Draft=Rascunho
Fields=Campos
MaxAttributeNumber=Não é possível definir mais do que %1 atributos para um componente de preço.
MoveDown=Mover para baixo
MoveUp=Mover para cima
PostingProfileName=Perfil de lançamento
 ;Label for posting profile name
PriceAdjustment=Revisão de preços
 ;Label for price adjustment component
PriceAdjustmentAttributes=Atributos de preço para revisões de preços
 ;Label for price adjustment attributes
PriceAttrbuteSource=Origem
 ;Label for the source of price attributes
PriceAttribute=Atributo de preço
PriceAttributeCatalog=Catálogo
PriceAttributeColor=Cor
PriceAttributeConfiguration=Configuração
PriceAttributeCustAccountNum=Conta de cliente
PriceAttributeCustGroup=Grupo de clientes
PriceAttributeCustMarkupGroup=Grupo de encargos de cliente
PriceAttributeCustSegment=Segmento
PriceAttributeCustType=Tipo de cliente
PriceAttributeDataType=Tipo de dados de atributo de preço
 ;It's not public facing.
PriceAttributeDlvMode=Modo de entrega
PriceAttributeDlvModeMarkupGroup=Grupo de encargos de entrega
PriceAttributeItemMarkupGroup=Grupo de encargos de item
PriceAttributeName=Nome
 ;Label for the name of price attributes
PriceAttributeProcessStatus=Estado do processo
 ;Label for price attribute process status
PriceAttributeProduct=Produto
PriceAttributeProductCategory=Categoria
PriceAttributeProductVariant=Variante de produto
PriceAttributeProviderNotFound=Não foi encontrado nenhum fornecedor de atributo de preço para %1.
 ;An error indicating customization is not correct.
PriceAttributeProviderNotSupported=O fornecedor %1 não suporta o atributo de preço %2.
 ;An error indicating customization is not correct.
PriceAttributePublish=Os atributos de preço foram publicados com êxito.
PriceAttributeRetailAffiliation=Afiliação
PriceAttributeRetailLoyaltyTier=Programa de fidelização
PriceAttributes=Atributos de preço
 ;Label for price attributes form
PriceAttributeSite=Local
PriceAttributeSize=Tamanho
PriceAttributeStatus=Estado de atributo de preço
 ;It's not public facing.
PriceAttributeStyle=Estilo
PriceAttributeType=Tipo
 ;Label for price attribute types
PriceAttributeTypeCustomFields=Campos personalizados
 ;Label for customization pricing attributes
PriceAttributeTypeEcoResAttribute=Atributos definidos pelo utilizador
 ;Type of an attribute references EcoResAttribute
PriceAttributeTypePredefinedFields=Campos predefinidos
 ;Type of a predefined attribute field
PriceAttributeWarehouse=Armazém
PriceComponent=Componente de preço
 ;Label for price component
PriceComponentCodeCurrencyMode=Modo de simultaneidade
 ;Label for price component code concurrency mode
PriceComponentCodeName=Código de componente de preço
 ;Label for price component code name
PriceComponentCodes=Códigos de componente de preço
 ;Label for price component codes form
PriceGroupAttributes=Atributos de preço para grupos de preços
 ;Price attributes for price groups
PriceGroupPricingRuleLink=Ligação entre o grupo de preços e a regra de preço
 ;Label for PriceGroupPricingRuleLink table
PriceGroups=Grupos de preços
 ;Label for price group
PricePublishStatus=Estado de publicação
PriceTrees=Árvores de preços
 ;Label for price trees
PricingRuleApplicabilities=Valores do atributo de preço
 ;Label for pricing rule applicability
PricingRuleApplicabilityLookupReference=Referências de aplicabilidade de regras de preços
 ;Label for pricing rule applicability references
PricingStructure=Estrutura de preços
Product=Produto
 ;Label for product attribute.
ProductDiscount=Desconto do produto
 ;Label for discount component
ProductDiscountAttributes=Atributos de preço para descontos de produtos
Published=Publicado
Publishing=Publicação
Rank=Classificação
 ;Priority for price rules.
Rebate=Abatimento
 ;Label for rebate component
Revert=Reverter
SalesAgreement=Acordo de venda
SalesOrderHeader=Cabeçalho da ordem de venda
 ;Label for sales order header attribute.
SalesOrderLine=Linha da ordem de venda
 ;Label for sales order line attribute.
SalesTradeAgreement=Acordo comercial de vendas
 ;Label for trade agreement component
ShippingDiscount=Desconto de envio
ShippingDiscountAttributes=Atributos de preço para descontos de envio
TenderDiscount=Desconto de pagamento
TenderDiscountAttributes=Atributos de preço para descontos de pagamento
TradeAgreementAttributes=Atributos de preço para acordos comerciais
 ;Price attributes for trade agreements
UnifiedPricingFeatureLabel=(Incompleto) Gestão de preços
 ;Feature name for unified pricing management
UnifiedPricingFeatureSummary=O módulo de gestão de preços fornece uma plataforma centralizada para os gestores de preços planearem, configurarem, gerirem, simularem e monitorizarem estratégias de preços omnicanal. Com esta funcionalidade ativada, as organizações podem configurar estruturas de preços flexíveis utilizando vários componentes de preço, como preços de base gerais, ofertas de longo prazo, promoções de curto prazo e reembolsos retroativos. As regras de preços podem ser definidas com base nos atributos do produto, do cliente e da encomenda. Os preços contextuais podem ser implementados em diferentes segmentos com base em condições predefinidas. O cálculo de preços em tempo real é efetuado com base num mecanismo de preços unificado que funciona de forma consistente nos processos de negócio da cadeia de fornecimento, de retalho e de comércio eletrónico.
 ;Feature summary for unified pricing management
