Added=추가됨
AttributeWithComponentCode=가격 책정 특성이 구성 요소 코드에 연결된 경우에는 삭제할 수 없습니다.
AutoCharge=자동 요금
 ;Label for charge component
BasePrice=기준 가격
CalculationSequence=가격 시퀀스
 ;Label for pricing calculation sequence
CannotDeleteDefaultTree=기본 가격 트리는 삭제할 수 없습니다.
CannotInsertPriceTree=가격 책정 트리는 하나만 허용됩니다.
Channel=채널
 ;Label for channel attribute.
ConcurrencyMode=동시성 모드
Customer=고객
 ;Label for customer attribute.
DefaultPriceTree=기본 가격 트리
 ;Label for default price tree
Deleted=삭제됨
DeletePriceAttribute=가격 책정 특성에서 레코드를 삭제하려고 합니다. 레코드를 삭제하시겠습니까?
Discount=할인
 ;Label for discount component
Draft=초안
Fields=필드
MaxAttributeNumber=가격 구성 요소에 대해 %1개 이상의 특성을 정의할 수 없습니다.
MoveDown=아래로 이동
MoveUp=위로 이동
PostingProfileName=프로필 게시
 ;Label for posting profile name
PriceAdjustment=가격 조정
 ;Label for price adjustment component
PriceAdjustmentAttributes=가격 조정을 위한 가격 특성
 ;Label for price adjustment attributes
PriceAttrbuteSource=원본
 ;Label for the source of price attributes
PriceAttribute=가격 특성
PriceAttributeCatalog=카탈로그
PriceAttributeColor=색상
PriceAttributeConfiguration=구성
PriceAttributeCustAccountNum=고객 계정
PriceAttributeCustGroup=고객 그룹
PriceAttributeCustMarkupGroup=고객 요금 그룹
PriceAttributeCustSegment=세그먼트
PriceAttributeCustType=고객 유형
PriceAttributeDataType=가격 특성 데이터 형식
 ;It's not public facing.
PriceAttributeDlvMode=배송 방식
PriceAttributeDlvModeMarkupGroup=배송 요금 그룹
PriceAttributeItemMarkupGroup=제품 요금 그룹
PriceAttributeName=이름
 ;Label for the name of price attributes
PriceAttributeProcessStatus=프로세스 상태
 ;Label for price attribute process status
PriceAttributeProduct=제품
PriceAttributeProductCategory=범주
PriceAttributeProductVariant=제품 변형
PriceAttributeProviderNotFound=%1에 대한 가격 책정 특성 공급자를 찾을 수 없습니다.
 ;An error indicating customization is not correct.
PriceAttributeProviderNotSupported=%1 공급자는 가격 책정 특성 %2을(를) 지원하지 않습니다.
 ;An error indicating customization is not correct.
PriceAttributePublish=가격 특성이 성공적으로 게시되었습니다.
PriceAttributeRetailAffiliation=제휴
PriceAttributeRetailLoyaltyTier=로열티 프로그램
PriceAttributes=가격 특성
 ;Label for price attributes form
PriceAttributeSite=현장
PriceAttributeSize=사이즈
PriceAttributeStatus=가격 특성 상태
 ;It's not public facing.
PriceAttributeStyle=스타일
PriceAttributeType=양식
 ;Label for price attribute types
PriceAttributeTypeCustomFields=사용자 지정 필드
 ;Label for customization pricing attributes
PriceAttributeTypeEcoResAttribute=사용자 정의 속성
 ;Type of an attribute references EcoResAttribute
PriceAttributeTypePredefinedFields=미리 정의된 필드
 ;Type of a predefined attribute field
PriceAttributeWarehouse=창고
PriceComponent=가격 구성 요소
 ;Label for price component
PriceComponentCodeCurrencyMode=동시성 모드
 ;Label for price component code concurrency mode
PriceComponentCodeName=가격 구성 요소 코드
 ;Label for price component code name
PriceComponentCodes=가격 구성 요소 코드
 ;Label for price component codes form
PriceGroupAttributes=가격 그룹을 위한 가격 특성
 ;Price attributes for price groups
PriceGroupPricingRuleLink=가격 그룹과 가격 책정 규칙 간 연결
 ;Label for PriceGroupPricingRuleLink table
PriceGroups=가격 그룹
 ;Label for price group
PricePublishStatus=게시 상태
PriceTrees=가격 트리
 ;Label for price trees
PricingRuleApplicabilities=가격 특성 값
 ;Label for pricing rule applicability
PricingRuleApplicabilityLookupReference=가격 책정 규칙 적용 가능성 참조
 ;Label for pricing rule applicability references
PricingStructure=가격 책정 구조
Product=제품
 ;Label for product attribute.
ProductDiscount=제품 할인
 ;Label for discount component
ProductDiscountAttributes=제품 할인을 위한 가격 특성
Published=게시됨
Publishing=게시 중
Rank=순위
 ;Priority for price rules.
Rebate=리베이트
 ;Label for rebate component
Revert=되돌리기
SalesAgreement=판매 계약
SalesOrderHeader=판매 주문 헤더
 ;Label for sales order header attribute.
SalesOrderLine=판매 주문 라인
 ;Label for sales order line attribute.
SalesTradeAgreement=판매 거래 계약
 ;Label for trade agreement component
ShippingDiscount=배송 할인
ShippingDiscountAttributes=배송 할인을 위한 가격 특성
TenderDiscount=입찰 할인
TenderDiscountAttributes=입찰 할인의 가격 책정 특성
TradeAgreementAttributes=무역 협정의 가격 책정 특성
 ;Price attributes for trade agreements
UnifiedPricingFeatureLabel=(불완전) 가격 책정 관리 매개 변수
 ;Feature name for unified pricing management
UnifiedPricingFeatureSummary=가격 책정 관리 모듈은 가격 책정 관리자가 옴니채널 가격 책정 전략을 계획, 구성, 관리, 시뮬레이션 및 모니터링할 수 있는 중앙 집중식 플랫폼을 제공합니다. 이 기능을 활성화하면 일반 기본 가격, 장기 거래, 단기 프로모션, 소급 리베이트 등 여러 가격 구성 요소를 사용하여 유연한 가격 책정 구조를 설정할 수 있습니다. 제품, 고객, 주문 특성에 따라 가격 책정 규칙을 정의할 수 있습니다. 사전 정의된 조건에 따라 다양한 세그먼트에 상황에 맞는 가격 책정을 적용할 수 있습니다. 실시간 가격 책정은 공급망, 소매 및 이커머스 업무 프로세스 전반에서 일관되게 작동하는 통합 가격 책정 엔진을 통해 이루어집니다.
 ;Feature summary for unified pricing management
