Added=Har lagts till
AttributeWithComponentCode=Det går inte att ta bort ett prisattribut när det är länkat till en komponentkod.
AutoCharge=Automatisk avgift
 ;Label for charge component
BasePrice=Grundpris
CalculationSequence=Prissättningssekvens
 ;Label for pricing calculation sequence
CannotDeleteDefaultTree=Det går inte att ta bort standardpristräd.
CannotInsertPriceTree=Endast ett pristräd är tillåtet.
Channel=Kanal
 ;Label for channel attribute.
ConcurrencyMode=Läge för samtidig körning
Customer=Kund
 ;Label for customer attribute.
DefaultPriceTree=Standardpristräd
 ;Label for default price tree
Deleted=Borttaget
DeletePriceAttribute=Du tar bort en post i prisattribut. Vill du ta bort posten?
Discount=Rabatt
 ;Label for discount component
Draft=Utkast
Fields=Fält
MaxAttributeNumber=Det går inte att definiera fler än %1 attribut för en priskomponent.
MoveDown=Flytta ned
MoveUp=Flytta upp
PostingProfileName=Bokföringsprofil
 ;Label for posting profile name
PriceAdjustment=Prisjustering
 ;Label for price adjustment component
PriceAdjustmentAttributes=Prisattribut för prisjusteringar
 ;Label for price adjustment attributes
PriceAttrbuteSource=Källa
 ;Label for the source of price attributes
PriceAttribute=Prisattribut
PriceAttributeCatalog=Katalog
PriceAttributeColor=Färg
PriceAttributeConfiguration=Inställningar
PriceAttributeCustAccountNum=Kundkonto
PriceAttributeCustGroup=Kundgrupp
PriceAttributeCustMarkupGroup=Kundavgiftsgrupp
PriceAttributeCustSegment=Segment
PriceAttributeCustType=Kundtyp
PriceAttributeDataType=Prisattributdatatyp
 ;It's not public facing.
PriceAttributeDlvMode=Leveranssätt
PriceAttributeDlvModeMarkupGroup=Leveransavgiftsgrupp
PriceAttributeItemMarkupGroup=Avgiftsgrupp för artikel
PriceAttributeName=Namn
 ;Label for the name of price attributes
PriceAttributeProcessStatus=Bearbetningsstatus
 ;Label for price attribute process status
PriceAttributeProduct=Produkt
PriceAttributeProductCategory=Kategori
PriceAttributeProductVariant=Produktvariant
PriceAttributeProviderNotFound=Hittade ingen prisattributprovider för %1.
 ;An error indicating customization is not correct.
PriceAttributeProviderNotSupported=Providern %1 stöder inte prisattributet %2.
 ;An error indicating customization is not correct.
PriceAttributePublish=Prisattributen har publicerats.
PriceAttributeRetailAffiliation=Anknytning
PriceAttributeRetailLoyaltyTier=Bonusprogram
PriceAttributes=Prisattribut
 ;Label for price attributes form
PriceAttributeSite=Plats
PriceAttributeSize=Storlek
PriceAttributeStatus=Prisattributstatus
 ;It's not public facing.
PriceAttributeStyle=Formatmall
PriceAttributeType=Typ
 ;Label for price attribute types
PriceAttributeTypeCustomFields=Anpassade fält
 ;Label for customization pricing attributes
PriceAttributeTypeEcoResAttribute=Användardefinierade attribut
 ;Type of an attribute references EcoResAttribute
PriceAttributeTypePredefinedFields=Fördefinierade fält
 ;Type of a predefined attribute field
PriceAttributeWarehouse=Lagerställe
PriceComponent=Priskomponent
 ;Label for price component
PriceComponentCodeCurrencyMode=Läge för samtidig körning
 ;Label for price component code concurrency mode
PriceComponentCodeName=Priskomponentkod
 ;Label for price component code name
PriceComponentCodes=Priskomponentkoder
 ;Label for price component codes form
PriceGroupAttributes=Prisattribut för prisgrupper
 ;Price attributes for price groups
PriceGroupPricingRuleLink=Länk mellan prisgrupp och prisregel
 ;Label for PriceGroupPricingRuleLink table
PriceGroups=Prisgrupper
 ;Label for price group
PricePublishStatus=Publiceringsstatus
PriceTrees=Pristräd
 ;Label for price trees
PricingRuleApplicabilities=Prisattributvärden
 ;Label for pricing rule applicability
PricingRuleApplicabilityLookupReference=Referenser för prisregeltillämplighet
 ;Label for pricing rule applicability references
PricingStructure=Prisstruktur
Product=Produkt
 ;Label for product attribute.
ProductDiscount=Produktrabatt
 ;Label for discount component
ProductDiscountAttributes=Prisattribut för produktrabatter
Published=Publicerat
Publishing=Publicering
Rank=Rangordning
 ;Priority for price rules.
Rebate=Rabatt
 ;Label for rebate component
Revert=Återställ
SalesAgreement=Försäljningsavtal
SalesOrderHeader=Försäljningsorderhuvud
 ;Label for sales order header attribute.
SalesOrderLine=Försäljningsorderrad
 ;Label for sales order line attribute.
SalesTradeAgreement=Handelsavtal
 ;Label for trade agreement component
ShippingDiscount=Leverantörsrabatt
ShippingDiscountAttributes=Prisattribut för leveransrabatter
TenderDiscount=Anbudsrabatt
TenderDiscountAttributes=Prisattribut för anbudsrabatter
TradeAgreementAttributes=Prisattribut för handelsavtal
 ;Price attributes for trade agreements
UnifiedPricingFeatureLabel=(Ofullständig) Prishantering
 ;Feature name for unified pricing management
UnifiedPricingFeatureSummary=Prishanteringsmodulen är en central plattform för prissättningschefer där de kan planera, konfigurera, hantera, simulera och övervaka prisstrategier för flerkanal. Med den här funktionen aktiverad kan organisationer ställa in flexibla prisstrukturer med flera priskomponenter, till exempel allmänna grundpriser, långfristiga erbjudanden, kortfristiga kampanjer och retrospektiva rabatter. Prissättningsregler kan definieras baserat på produkt-, kund- och orderattribut. Kontextpriser kan distribueras till olika segment baserat på fördefinierade villkor. Beräkning av realtidspris baseras på en enhetlig prissättningsmotor som fungerar konsekvent i över alla affärsprocesser för leveranskedja, butik och e-handel.
 ;Feature summary for unified pricing management
