Added=Aggiunto
AttributeWithComponentCode=Impossibile eliminare un attributo di prezzo quando è collegato a un codice componente.
AutoCharge=Addebito automatico
 ;Label for charge component
BasePrice=Prezzo di base
CalculationSequence=Sequenza di determinazione prezzo
 ;Label for pricing calculation sequence
CannotDeleteDefaultTree=Impossibile eliminare l'albero prezzi predefinito.
CannotInsertPriceTree=È consentito solo un albero prezzi.
Channel=Canale
 ;Label for channel attribute.
ConcurrencyMode=Modalità di concorrenza
Customer=Cliente
 ;Label for customer attribute.
DefaultPriceTree=Albero prezzi predefinito
 ;Label for default price tree
Deleted=Eliminato
DeletePriceAttribute=Verrà eliminato un record negli attributi di prezzo. Eliminare il record?
Discount=Sconto
 ;Label for discount component
Draft=Bozza
Fields=Campi
MaxAttributeNumber=Impossibile definire più di %1 attributi per un componente di prezzo.
MoveDown=Sposta giù
MoveUp=Sposta su
PostingProfileName=Profilo registrazione
 ;Label for posting profile name
PriceAdjustment=Rettifica prezzo
 ;Label for price adjustment component
PriceAdjustmentAttributes=Attributi di prezzo per rettifiche prezzo
 ;Label for price adjustment attributes
PriceAttrbuteSource=Origine
 ;Label for the source of price attributes
PriceAttribute=Attributo di prezzo
PriceAttributeCatalog=Catalogo
PriceAttributeColor=Colore
PriceAttributeConfiguration=Configurazione
PriceAttributeCustAccountNum=Conto cliente
PriceAttributeCustGroup=Gruppo di clienti
PriceAttributeCustMarkupGroup=Gruppo di addebiti cliente
PriceAttributeCustSegment=Segmento
PriceAttributeCustType=Tipo di cliente
PriceAttributeDataType=Tipo di dati attributo di prezzo
 ;It's not public facing.
PriceAttributeDlvMode=Modalità di consegna
PriceAttributeDlvModeMarkupGroup=Gruppo di spese di consegna
PriceAttributeItemMarkupGroup=Gruppo di addebiti articoli
PriceAttributeName=Nome
 ;Label for the name of price attributes
PriceAttributeProcessStatus=Stato processo
 ;Label for price attribute process status
PriceAttributeProduct=Prodotto
PriceAttributeProductCategory=Categoria
PriceAttributeProductVariant=Variante prodotto
PriceAttributeProviderNotFound=Nessun provider di attributi di prezzo trovato per %1.
 ;An error indicating customization is not correct.
PriceAttributeProviderNotSupported=Il provider %1 non supporta l'attributo di prezzo %2.
 ;An error indicating customization is not correct.
PriceAttributePublish=Pubblicazione degli attributi di prezzo completata.
PriceAttributeRetailAffiliation=Rapporto
PriceAttributeRetailLoyaltyTier=Programma fedeltà
PriceAttributes=Attributi di prezzo
 ;Label for price attributes form
PriceAttributeSite=Sito
PriceAttributeSize=Dimensioni
PriceAttributeStatus=Stato attributo di prezzo
 ;It's not public facing.
PriceAttributeStyle=Stile
PriceAttributeType=Tipo
 ;Label for price attribute types
PriceAttributeTypeCustomFields=Campi personalizzati
 ;Label for customization pricing attributes
PriceAttributeTypeEcoResAttribute=Attributi definiti dall'utente
 ;Type of an attribute references EcoResAttribute
PriceAttributeTypePredefinedFields=Campi predefiniti
 ;Type of a predefined attribute field
PriceAttributeWarehouse=Magazzino
PriceComponent=Componente prezzo
 ;Label for price component
PriceComponentCodeCurrencyMode=Modalità di concorrenza
 ;Label for price component code concurrency mode
PriceComponentCodeName=Codice componente prezzo
 ;Label for price component code name
PriceComponentCodes=Codici componente prezzo
 ;Label for price component codes form
PriceGroupAttributes=Attributi di prezzo per gruppi di prezzi
 ;Price attributes for price groups
PriceGroupPricingRuleLink=Collegamento tra gruppo di prezzi e regola di determinazione prezzo
 ;Label for PriceGroupPricingRuleLink table
PriceGroups=Gruppi di prezzi
 ;Label for price group
PricePublishStatus=Stato pubblicazione
PriceTrees=Alberi prezzi
 ;Label for price trees
PricingRuleApplicabilities=Valori di attributi di prezzo
 ;Label for pricing rule applicability
PricingRuleApplicabilityLookupReference=Riferimenti applicabilità regola di determinazione prezzo
 ;Label for pricing rule applicability references
PricingStructure=Struttura determinazione prezzo
Product=Prodotto
 ;Label for product attribute.
ProductDiscount=Sconto prodotti
 ;Label for discount component
ProductDiscountAttributes=Attributi di prezzo per sconti prodotti
Published=Pubblicato
Publishing=Editoria
Rank=Classificazione
 ;Priority for price rules.
Rebate=Sconto
 ;Label for rebate component
Revert=Ripristina
SalesAgreement=Contratto di vendita
SalesOrderHeader=Intestazione ordine cliente
 ;Label for sales order header attribute.
SalesOrderLine=Riga ordine cliente
 ;Label for sales order line attribute.
SalesTradeAgreement=Accordo commerciale vendite
 ;Label for trade agreement component
ShippingDiscount=Sconto spedizione
ShippingDiscountAttributes=Attributi di prezzo per sconti spedizione
TenderDiscount=Sconto metodo di pagamento
TenderDiscountAttributes=Attributi di prezzo per sconti metodo di pagamento
TradeAgreementAttributes=Attributi di prezzo per accordi commerciali
 ;Price attributes for trade agreements
UnifiedPricingFeatureLabel=(Incompleto) Gestione prezzi
 ;Feature name for unified pricing management
UnifiedPricingFeatureSummary=Il modulo Gestione prezzi offre una piattaforma centralizzata per i responsabili dei prezzi che pianificano, configurano, gestiscono, simulano e monitorano strategie di determinazione prezzi multicanale. Abilitando questa funzionalità, le organizzazioni possono impostare strutture di determinazione prezzi flessibili tramite più componenti di prezzo, ad esempio prezzi di base generali, accordi a lungo termine, promozioni a breve termine e sconti retroattivi. Le regole di determinazione prezzi possono essere definite in base agli attributi del prodotto, del cliente e dell'ordine. È possibile implementare una strategia di determinazione prezzi contestuale in segmenti diversi secondo condizioni predefinite. Il calcolo dei prezzi in tempo reale è basato su un motore di determinazione prezzi unificato che funziona in modo coerente nei processi aziendali di catena di approvvigionamento, vendita al dettaglio ed e-commerce.
 ;Feature summary for unified pricing management
