Added=נוסף
AttributeWithComponentCode=לא ניתן למחוק מאפיין מחיר כאשר הוא מקושר לקוד רכיב.
AutoCharge=חיוב אוטומטי
 ;Label for charge component
BasePrice=מחיר בסיס
CalculationSequence=רצף תמחור
 ;Label for pricing calculation sequence
CannotDeleteDefaultTree=לא ניתן למחוק את ברירת המחדל של עץ המחירים.
CannotInsertPriceTree=מותר רק עץ מחירים אחד.
Channel=ערוץ
 ;Label for channel attribute.
ConcurrencyMode=מצב התרחשות בו-זמנית
Customer=לקוח
 ;Label for customer attribute.
DefaultPriceTree=ברירת מחדל של עץ מחירים
 ;Label for default price tree
Deleted=נמחק
DeletePriceAttribute=אתה עומד למחוק רשומה במאפייני מחיר. למחוק את הרשומה?
Discount=הנחה
 ;Label for discount component
Draft=טיוטה
Fields=שדות
MaxAttributeNumber=לא ניתן להגדיר יותר מ- %1 מאפיינים עבור רכיב מחיר.
MoveDown=הזז למטה
MoveUp=הזז למעלה
PostingProfileName=פרופיל רישום
 ;Label for posting profile name
PriceAdjustment=התאמת מחירים
 ;Label for price adjustment component
PriceAdjustmentAttributes=מאפייני מחיר עבור התאמות מחיר
 ;Label for price adjustment attributes
PriceAttrbuteSource=מקור
 ;Label for the source of price attributes
PriceAttribute=תכונת מחיר
PriceAttributeCatalog=קטלוג
PriceAttributeColor=צבע
PriceAttributeConfiguration=קביעת תצורה
PriceAttributeCustAccountNum=חשבון לקוח
PriceAttributeCustGroup=קבוצת לקוחות
PriceAttributeCustMarkupGroup=קבוצת חיובים של לקוחות
PriceAttributeCustSegment=פלח
PriceAttributeCustType=סוג לקוח
PriceAttributeDataType=סוג נתונים של תכונת מחיר
 ;It's not public facing.
PriceAttributeDlvMode=אמצעי מסירה
PriceAttributeDlvModeMarkupGroup=קבוצה של חיובי מסירה
PriceAttributeItemMarkupGroup=קבוצה של חיוב פריטים
PriceAttributeName=שם
 ;Label for the name of price attributes
PriceAttributeProcessStatus=מצב התהליך
 ;Label for price attribute process status
PriceAttributeProduct=מוצר
PriceAttributeProductCategory=קטגוריה
PriceAttributeProductVariant=מוצר משני
PriceAttributeProviderNotFound=לא נמצא ספק מאפייני מחיר עבור %1.
 ;An error indicating customization is not correct.
PriceAttributeProviderNotSupported=הספק %1 לא תומך בתכונת מחיר %2.
 ;An error indicating customization is not correct.
PriceAttributePublish=מאפייני מחיר פורסמו בהצלחה.
PriceAttributeRetailAffiliation=שיוך
PriceAttributeRetailLoyaltyTier=תוכנית מועדון
PriceAttributes=תכונות מחיר
 ;Label for price attributes form
PriceAttributeSite=אתר
PriceAttributeSize=גודל
PriceAttributeStatus=מצב של מאפיין מחיר
 ;It's not public facing.
PriceAttributeStyle=סגנון
PriceAttributeType=סוג
 ;Label for price attribute types
PriceAttributeTypeCustomFields=שדות מותאמים אישית
 ;Label for customization pricing attributes
PriceAttributeTypeEcoResAttribute=תכונות שמוגדרות על ידי משתמש
 ;Type of an attribute references EcoResAttribute
PriceAttributeTypePredefinedFields=שדות שמוגדרים מראש
 ;Type of a predefined attribute field
PriceAttributeWarehouse=מחסן
PriceComponent=רכיב מחיר
 ;Label for price component
PriceComponentCodeCurrencyMode=מצב התרחשות בו-זמנית
 ;Label for price component code concurrency mode
PriceComponentCodeName=קוד רכיב מחיר
 ;Label for price component code name
PriceComponentCodes=קודי רכיב מחיר
 ;Label for price component codes form
PriceGroupAttributes=מאפייני מחיר עבור קבוצות מחיר
 ;Price attributes for price groups
PriceGroupPricingRuleLink=קישור בין קבוצת מחירים לכלל התמחור
 ;Label for PriceGroupPricingRuleLink table
PriceGroups=קבוצות מחירים
 ;Label for price group
PricePublishStatus=מצב פרסום
PriceTrees=עצי מחירים
 ;Label for price trees
PricingRuleApplicabilities=ערכים של מאפיין מחיר
 ;Label for pricing rule applicability
PricingRuleApplicabilityLookupReference=הפניות לתחולת כלל תמחור
 ;Label for pricing rule applicability references
PricingStructure=מבנה התמחור
Product=מוצר
 ;Label for product attribute.
ProductDiscount=הנחה על מוצר
 ;Label for discount component
ProductDiscountAttributes=מאפייני מחיר להנחות מוצרים
Published=‏‏פורסם‬
Publishing=הוצאה לאור
Rank=‏‏דירוג‬
 ;Priority for price rules.
Rebate=החזר
 ;Label for rebate component
Revert=‏‏חזור‬
SalesAgreement=הסכם מכירות
SalesOrderHeader=כותרת של הזמנת מכירות
 ;Label for sales order header attribute.
SalesOrderLine=שורה של הזמנת מכירות
 ;Label for sales order line attribute.
SalesTradeAgreement=הסכם מסחרי של מכירות
 ;Label for trade agreement component
ShippingDiscount=הנחת משלוח
ShippingDiscountAttributes=מאפייני מחיר להנחות על משלוח
TenderDiscount=הנחת אמצעי תשלום
TenderDiscountAttributes=מאפייני מחיר להנחות על מכרז
TradeAgreementAttributes=מאפייני מחיר עבור הסכמים מסחריים
 ;Price attributes for trade agreements
UnifiedPricingFeatureLabel=(לא הושלם) ניהול תמחור
 ;Feature name for unified pricing management
UnifiedPricingFeatureSummary=מודול ניהול תמחור מספק פלטפורמה מרכזית למנהלי תמחור לתכנון, תצורה, ניהול, הדמיה ומעקב אחר אסטרטגיות תמחור מרובה ערוצים. כאשר תכונה זו מופעלת, ארגונים יכולים להגדיר מבני תמחור גמישים תוך שימוש במספר מרכיבי מחיר כגון מחירי בסיס כלליים, עסקאות ארוכות טווח, מבצעים לטווח קצר והחזרים בדיעבד. ניתן להגדיר כללי תמחור בהתבסס על תכונות מוצר, לקוח והזמנה. ניתן להפיץ תמחור הקשרי למקטעים שונים בהתבסס על תנאים מוגדרים מראש. חישוב תמחור בזמן אמת מופעל על ידי מנוע תמחור מאוחד שפועל באופן עקבי בתהליכים עסקיים של שרשרת האספקה, הקמעונאות והמסחר האלקטרוני.
 ;Feature summary for unified pricing management
