Added=Hozzáadva
AttributeWithComponentCode=Nem törölheti az árattribútumot, ha az egy összetevőkódhoz van kapcsolva.
AutoCharge=Automatikus díj
 ;Label for charge component
BasePrice=Alapár
CalculationSequence=Árképzési sorrend
 ;Label for pricing calculation sequence
CannotDeleteDefaultTree=Az alapértelmezett árfa nem törölhető.
CannotInsertPriceTree=Csak egy árfa megengedett.
Channel=Csatorna
 ;Label for channel attribute.
ConcurrencyMode=Feldolgozási mód
Customer=Vevő
 ;Label for customer attribute.
DefaultPriceTree=Alapértelmezett árfa
 ;Label for default price tree
Deleted=Törölve
DeletePriceAttribute=Törölni készül egy rekordot az árattribútumok közül. Törli a rekordot?
Discount=Engedmény
 ;Label for discount component
Draft=Vázlat
Fields=Mezők
MaxAttributeNumber=Az árösszetevőnél kevesebb, mint %1 attribútumot határozhat meg.
MoveDown=Mozgatás lefelé
MoveUp=Mozgatás felfelé
PostingProfileName=Feladási profil
 ;Label for posting profile name
PriceAdjustment=Ármódosítás
 ;Label for price adjustment component
PriceAdjustmentAttributes=Ármódosítások árattribútumai
 ;Label for price adjustment attributes
PriceAttrbuteSource=Forrás
 ;Label for the source of price attributes
PriceAttribute=Árattribútum
PriceAttributeCatalog=Katalógus
PriceAttributeColor=Szín
PriceAttributeConfiguration=Konfiguráció
PriceAttributeCustAccountNum=Vevői számla
PriceAttributeCustGroup=Vevőcsoport
PriceAttributeCustMarkupGroup=Vevő költségcsoportja
PriceAttributeCustSegment=Szegmens
PriceAttributeCustType=Vevőtípus
PriceAttributeDataType=Árattribútum adattípusa
 ;It's not public facing.
PriceAttributeDlvMode=Szállítás módja
PriceAttributeDlvModeMarkupGroup=Szállításiköltség-csoport
PriceAttributeItemMarkupGroup=Cikk-költségcsoport
PriceAttributeName=Név
 ;Label for the name of price attributes
PriceAttributeProcessStatus=Folyamat állapota
 ;Label for price attribute process status
PriceAttributeProduct=Termék
PriceAttributeProductCategory=Kategória
PriceAttributeProductVariant=Termékváltozat
PriceAttributeProviderNotFound=Nem található árattribútum-szolgáltató a(z) %1 lehetőséghez.
 ;An error indicating customization is not correct.
PriceAttributeProviderNotSupported=A(z) %1 szolgáltató nem támogatja a(z) %2 árattribútumot.
 ;An error indicating customization is not correct.
PriceAttributePublish=Az árattribútumok közzététele sikeresen megtörtént.
PriceAttributeRetailAffiliation=Fiók
PriceAttributeRetailLoyaltyTier=Hűségprogram
PriceAttributes=Árattribútumok
 ;Label for price attributes form
PriceAttributeSite=Hely
PriceAttributeSize=Méret
PriceAttributeStatus=Árattribútum állapota
 ;It's not public facing.
PriceAttributeStyle=Stílus
PriceAttributeType=Típus
 ;Label for price attribute types
PriceAttributeTypeCustomFields=Egyéni mezők
 ;Label for customization pricing attributes
PriceAttributeTypeEcoResAttribute=Felhasználó által meghatározott attribútumok
 ;Type of an attribute references EcoResAttribute
PriceAttributeTypePredefinedFields=Előre meghatározott mezők
 ;Type of a predefined attribute field
PriceAttributeWarehouse=Raktár
PriceComponent=Árösszetevő
 ;Label for price component
PriceComponentCodeCurrencyMode=Feldolgozási mód
 ;Label for price component code concurrency mode
PriceComponentCodeName=Árösszetevő kódja
 ;Label for price component code name
PriceComponentCodes=Árösszetevő kódjai
 ;Label for price component codes form
PriceGroupAttributes=Árcsoportok árattribútumai
 ;Price attributes for price groups
PriceGroupPricingRuleLink=Az árcsoport és az árképzési szabály közötti kapcsolat
 ;Label for PriceGroupPricingRuleLink table
PriceGroups=Árcsoportok
 ;Label for price group
PricePublishStatus=Közzététel állapota
PriceTrees=Árfák
 ;Label for price trees
PricingRuleApplicabilities=Árattribútum értékei
 ;Label for pricing rule applicability
PricingRuleApplicabilityLookupReference=Árképzési szabály alkalmazhatósági hivatkozásai
 ;Label for pricing rule applicability references
PricingStructure=Árképzési szerkezet
Product=Termék
 ;Label for product attribute.
ProductDiscount=Termék engedménye
 ;Label for discount component
ProductDiscountAttributes=Termékengedmények árattribútumai
Published=Közzétéve
Publishing=Kiadóvállalatok
Rank=Helyezés
 ;Priority for price rules.
Rebate=Visszatérítés
 ;Label for rebate component
Revert=Visszaállítás
SalesAgreement=Értékesítési szerződés
SalesOrderHeader=Értékesítési rendelés fejléce
 ;Label for sales order header attribute.
SalesOrderLine=Értékesítésirendelés-sor
 ;Label for sales order line attribute.
SalesTradeAgreement=Értékesítési kereskedelmi megállapodás
 ;Label for trade agreement component
ShippingDiscount=Szállítási engedmény
ShippingDiscountAttributes=Szállítási engedmények árattribútumai
TenderDiscount=Fizetőeszköz engedménye
TenderDiscountAttributes=Fizetőeszköz-engedmények árattribútumai
TradeAgreementAttributes=Kereskedelmi megállapodások árattribútumai
 ;Price attributes for trade agreements
UnifiedPricingFeatureLabel=(Hiányos) Díjszabás kezelése
 ;Feature name for unified pricing management
UnifiedPricingFeatureSummary=A Díjszabás kezelése modul egy központosított platformot biztosít az árképzési vezetők számára az omnicsatornás árképzési stratégiák megtervezéséhez, konfigurálásához, kezeléséhez, szimulálásához és monitorozásához. A funkció engedélyezésével a vállalatok rugalmas árképzési struktúrákat állíthatnak be olyan árösszetevők használatával, mint az általános alapárak, a hosszú távú ügyletek, a rövid távú promóciók és a visszamenőleges visszatérítések. Az árképzési szabályok a termék, a vevő és a rendelés attribútumai alapján határozhatók meg. A környezeti árképzés előre meghatározott feltételek alapján vezethető be a különböző szegmensekbe. A valós idejű árkalkulációt egy egységes árképzési motor hajtja, amely egységesen működik az ellátási láncon, a kiskereskedelmi és az e-kereskedelmi üzleti folyamatokon keresztül.
 ;Feature summary for unified pricing management
