Added=Toegevoegd
AttributeWithComponentCode=U kunt een prijskenmerk niet verwijderen als het is gekoppeld aan een componentcode.
AutoCharge=Automatische kostprijs
 ;Label for charge component
BasePrice=Basisprijs
CalculationSequence=Prijsreeks
 ;Label for pricing calculation sequence
CannotDeleteDefaultTree=De standaardprijsstructuur kan niet worden verwijderd.
CannotInsertPriceTree=Slechts één prijsstructuur is toegestaan.
Channel=Kanaal
 ;Label for channel attribute.
ConcurrencyMode=Gelijktijdigheidsmodus
Customer=Klant
 ;Label for customer attribute.
DefaultPriceTree=Standaardprijsstructuur
 ;Label for default price tree
Deleted=Verwijderd
DeletePriceAttribute=U gaat een record in Prijskenmerken verwijderen. Weet u zeker dat u dit record wilt verwijderen?
Discount=Korting
 ;Label for discount component
Draft=Concept
Fields=Velden
MaxAttributeNumber=U kunt niet meer dan %1 kenmerken definiëren voor een prijscomponent.
MoveDown=Omlaag verplaatsen
MoveUp=Omhoog verplaatsen
PostingProfileName=Boekingsprofiel
 ;Label for posting profile name
PriceAdjustment=Prijscorrectie
 ;Label for price adjustment component
PriceAdjustmentAttributes=Prijskenmerken voor prijscorrecties
 ;Label for price adjustment attributes
PriceAttrbuteSource=Bron
 ;Label for the source of price attributes
PriceAttribute=Prijskenmerk
PriceAttributeCatalog=Catalogus
PriceAttributeColor=Kleur
PriceAttributeConfiguration=Configuratie
PriceAttributeCustAccountNum=Klantrekening
PriceAttributeCustGroup=Klantgroep
PriceAttributeCustMarkupGroup=Kostprijsgroep van klant
PriceAttributeCustSegment=Segment
PriceAttributeCustType=Klanttype
PriceAttributeDataType=Gegevenstype van prijskenmerk
 ;It's not public facing.
PriceAttributeDlvMode=Leveringsmethode
PriceAttributeDlvModeMarkupGroup=Kostprijzengroep voor levering
PriceAttributeItemMarkupGroup=Kostprijzengroep van artikel
PriceAttributeName=Naam
 ;Label for the name of price attributes
PriceAttributeProcessStatus=Verwerkingsstatus
 ;Label for price attribute process status
PriceAttributeProduct=Product
PriceAttributeProductCategory=Categorie
PriceAttributeProductVariant=Productvariant
PriceAttributeProviderNotFound=Er is geen prijskenmerkprovider gevonden voor %1.
 ;An error indicating customization is not correct.
PriceAttributeProviderNotSupported=De provider %1 ondersteunt niet het prijskenmerk %2.
 ;An error indicating customization is not correct.
PriceAttributePublish=De prijskenmerken zijn gepubliceerd.
PriceAttributeRetailAffiliation=Affiliatie
PriceAttributeRetailLoyaltyTier=Loyaliteitsprogramma
PriceAttributes=Prijskenmerken
 ;Label for price attributes form
PriceAttributeSite=Locatie
PriceAttributeSize=Grootte
PriceAttributeStatus=Status van prijskenmerk
 ;It's not public facing.
PriceAttributeStyle=Stijl
PriceAttributeType=Type
 ;Label for price attribute types
PriceAttributeTypeCustomFields=Aangepaste velden
 ;Label for customization pricing attributes
PriceAttributeTypeEcoResAttribute=Door gebruiker gedefinieerde kenmerken
 ;Type of an attribute references EcoResAttribute
PriceAttributeTypePredefinedFields=Vooraf gedefinieerde velden
 ;Type of a predefined attribute field
PriceAttributeWarehouse=Magazijn
PriceComponent=Prijscomponent
 ;Label for price component
PriceComponentCodeCurrencyMode=Gelijktijdigheidsmodus
 ;Label for price component code concurrency mode
PriceComponentCodeName=Prijscomponentcode
 ;Label for price component code name
PriceComponentCodes=Prijscomponentcodes
 ;Label for price component codes form
PriceGroupAttributes=Prijskenmerken voor prijsgroepen
 ;Price attributes for price groups
PriceGroupPricingRuleLink=Koppeling tussen prijsgroep en prijsregel
 ;Label for PriceGroupPricingRuleLink table
PriceGroups=Prijsgroepen
 ;Label for price group
PricePublishStatus=Publicatiestatus
PriceTrees=Prijsstructuren
 ;Label for price trees
PricingRuleApplicabilities=Prijskenmerkwaarden
 ;Label for pricing rule applicability
PricingRuleApplicabilityLookupReference=Verwijzingen voor toepasbaarheid van prijsregels
 ;Label for pricing rule applicability references
PricingStructure=Prijsstructuur
Product=Product
 ;Label for product attribute.
ProductDiscount=Productkorting
 ;Label for discount component
ProductDiscountAttributes=Prijskenmerken voor productkortingen
Published=Gepubliceerd
Publishing=Uitgeverijbranche
Rank=Positie
 ;Priority for price rules.
Rebate=Korting
 ;Label for rebate component
Revert=Herstellen
SalesAgreement=Verkoopovereenkomst
SalesOrderHeader=Koptekst van verkooporder
 ;Label for sales order header attribute.
SalesOrderLine=Verkooporderregel
 ;Label for sales order line attribute.
SalesTradeAgreement=Handelsovereenkomst voor verkoop
 ;Label for trade agreement component
ShippingDiscount=Korting voor verzending
ShippingDiscountAttributes=Prijskenmerken voor verzendkortingen
TenderDiscount=Korting betalingsmethode
TenderDiscountAttributes=Prijskenmerken voor kortingen voor betalingsmethode
TradeAgreementAttributes=Prijskenmerken voor handelsovereenkomsten
 ;Price attributes for trade agreements
UnifiedPricingFeatureLabel=(Incompleet) Prijzenbeheer
 ;Feature name for unified pricing management
UnifiedPricingFeatureSummary=De module Prijzenbeheer biedt een centraal platform waar prijsmanagers omnichannel-prijsstrategieën kunnen plannen, configureren, beheren, simuleren en bewaken. Met deze functie kunnen organisaties flexibele prijsstructuren opzetten met meerdere prijscomponenten, zoals algemene basisprijzen, langetermijndeals, kortetermijnpromoties en kortingen achteraf. Prijsregels kunnen worden gedefinieerd op basis van kenmerken van producten, klanten en orders. Contextuele prijzen kunnen worden uitgerold naar verschillende segmenten op basis van vooraf gedefinieerde voorwaarden. Realtime prijsberekeningen worden aangestuurd door een uniforme prijsmechanisme die consistent werkt in de bedrijfsprocessen van toeleveringsketens, de detailhandel en e-commerce.
 ;Feature summary for unified pricing management
