Added=Ditambahkan
AttributeWithComponentCode=Anda tidak dapat menghapus atribut harga ketika atribut tersebut ditautkan ke kode komponen.
AutoCharge=Biaya otomatis
 ;Label for charge component
BasePrice=Harga dasar
CalculationSequence=Urutan harga
 ;Label for pricing calculation sequence
CannotDeleteDefaultTree=Struktur harga default tidak dapat dihapus.
CannotInsertPriceTree=Hanya dapat menggunakan satu struktur harga.
Channel=Saluran
 ;Label for channel attribute.
ConcurrencyMode=Mode konkurensi
Customer=Pelanggan
 ;Label for customer attribute.
DefaultPriceTree=Struktur harga default
 ;Label for default price tree
Deleted=Dihapus
DeletePriceAttribute=Anda akan menghapus data dalam atribut harga. Hapus data?
Discount=Diskon
 ;Label for discount component
Draft=Draf
Fields=Bidang
MaxAttributeNumber=Anda tidak bisa mendefinisikan lebih dari %1 atribut untuk komponen harga.
MoveDown=Pindah ke bawah
MoveUp=Pindah ke atas
PostingProfileName=Profil posting
 ;Label for posting profile name
PriceAdjustment=Penyesuaian harga
 ;Label for price adjustment component
PriceAdjustmentAttributes=Atribut harga untuk penyesuaian harga
 ;Label for price adjustment attributes
PriceAttrbuteSource=Sumber
 ;Label for the source of price attributes
PriceAttribute=Atribut harga
PriceAttributeCatalog=Katalog
PriceAttributeColor=Warna
PriceAttributeConfiguration=Konfigurasi
PriceAttributeCustAccountNum=Akun pelanggan
PriceAttributeCustGroup=Grup pelanggan
PriceAttributeCustMarkupGroup=Grup biaya pelanggan
PriceAttributeCustSegment=Segmen
PriceAttributeCustType=Jenis pelanggan
PriceAttributeDataType=Jenis data atribut harga
 ;It's not public facing.
PriceAttributeDlvMode=Mode pengiriman
PriceAttributeDlvModeMarkupGroup=Grup biaya pengiriman
PriceAttributeItemMarkupGroup=Grup biaya item
PriceAttributeName=Nama
 ;Label for the name of price attributes
PriceAttributeProcessStatus=Status proses
 ;Label for price attribute process status
PriceAttributeProduct=Produk
PriceAttributeProductCategory=Kategori
PriceAttributeProductVariant=Varian produk
PriceAttributeProviderNotFound=Tidak ditemukan penyedia atribut harga untuk %1.
 ;An error indicating customization is not correct.
PriceAttributeProviderNotSupported=Penyedia %1 tidak mendukung atribut harga %2.
 ;An error indicating customization is not correct.
PriceAttributePublish=Atribut harga telah berhasil dipublikasikan.
PriceAttributeRetailAffiliation=Afiliasi
PriceAttributeRetailLoyaltyTier=Loyalty program
PriceAttributes=Atribut harga
 ;Label for price attributes form
PriceAttributeSite=Lokasi
PriceAttributeSize=Ukuran
PriceAttributeStatus=Status atribut harga
 ;It's not public facing.
PriceAttributeStyle=Gaya
PriceAttributeType=Jenis
 ;Label for price attribute types
PriceAttributeTypeCustomFields=Bidang kustom
 ;Label for customization pricing attributes
PriceAttributeTypeEcoResAttribute=Atribut yang ditentukan pengguna
 ;Type of an attribute references EcoResAttribute
PriceAttributeTypePredefinedFields=Bidang yang ditentukan sebelumnya
 ;Type of a predefined attribute field
PriceAttributeWarehouse=Gudang
PriceComponent=Komponen harga
 ;Label for price component
PriceComponentCodeCurrencyMode=Mode konkurensi
 ;Label for price component code concurrency mode
PriceComponentCodeName=Kode komponen harga
 ;Label for price component code name
PriceComponentCodes=Kode komponen harga
 ;Label for price component codes form
PriceGroupAttributes=Atribut harga untuk grup harga
 ;Price attributes for price groups
PriceGroupPricingRuleLink=Keterkaitan antara grup harga dan aturan harga
 ;Label for PriceGroupPricingRuleLink table
PriceGroups=Grup harga
 ;Label for price group
PricePublishStatus=Status penerbitan
PriceTrees=Struktur harga
 ;Label for price trees
PricingRuleApplicabilities=Nilai atribut harga
 ;Label for pricing rule applicability
PricingRuleApplicabilityLookupReference=Referensi penerapan aturan harga
 ;Label for pricing rule applicability references
PricingStructure=Struktur harga
Product=Produk
 ;Label for product attribute.
ProductDiscount=Diskon produk
 ;Label for discount component
ProductDiscountAttributes=Atribut harga untuk diskon produk
Published=Dipublikasikan
Publishing=Penerbitan
Rank=Peringkat
 ;Priority for price rules.
Rebate=Rabat
 ;Label for rebate component
Revert=Kembalikan
SalesAgreement=Perjanjian penjualan
SalesOrderHeader=Header pesanan penjualan
 ;Label for sales order header attribute.
SalesOrderLine=Baris pesanan penjualan
 ;Label for sales order line attribute.
SalesTradeAgreement=Perjanjian dagang penjualan
 ;Label for trade agreement component
ShippingDiscount=Diskon pengiriman
ShippingDiscountAttributes=Atribut harga untuk diskon pengiriman
TenderDiscount=Diskon tender
TenderDiscountAttributes=Atribut harga untuk diskon tender
TradeAgreementAttributes=Atribut harga untuk kesepakatan dagang
 ;Price attributes for trade agreements
UnifiedPricingFeatureLabel=(Tidak lengkap) Manajemen penetapan harga
 ;Feature name for unified pricing management
UnifiedPricingFeatureSummary=Modul manajemen penetapan harga menyediakan platform terpusat bagi manajer harga untuk merencanakan, mengonfigurasi, mengelola, mensimulasikan, dan memantau strategi harga multisaluran. Dengan mengaktifkan fitur ini, organisasi dapat menyiapkan struktur harga yang fleksibel menggunakan berbagai komponen harga seperti harga dasar umum, penawaran jangka panjang, promosi jangka pendek, dan rabat retrospektif. Aturan harga dapat ditentukan berdasarkan atribut produk, pelanggan, dan pesanan. Harga kontekstual dapat diterapkan ke berbagai segmen berdasarkan kondisi yang telah ditentukan. Perhitungan harga secara waktu nyata didukung oleh mesin harga terpadu yang bekerja secara konsisten di seluruh rantai pasokan, retail, dan proses bisnis e-niaga.
 ;Feature summary for unified pricing management
