Added=Įtraukta
AttributeWithComponentCode=Negalite panaikinti kainos atributo, kai jis susietas su komponento kodu.
AutoCharge=Automatinis apmokestinimas
 ;Label for charge component
BasePrice=Bazinė kaina
CalculationSequence=Kainodaros seka
 ;Label for pricing calculation sequence
CannotDeleteDefaultTree=Negalima panaikinti numatytojo kainų medžio.
CannotInsertPriceTree=Leidžiama naudoti tik vieną kainų medį.
Channel=Kanalas
 ;Label for channel attribute.
ConcurrencyMode=Vienalaikiškumo režimas
Customer=Klientas
 ;Label for customer attribute.
DefaultPriceTree=Numatytasis kainų medis
 ;Label for default price tree
Deleted=Panaikinta
DeletePriceAttribute=Ketinate panaikinti kainos atributo įrašą. Ar naikinti įrašą?
Discount=Nuolaida
 ;Label for discount component
Draft=Juodraštis
Fields=Laukai
MaxAttributeNumber=Kainos komponentui negalima nurodyti daugiau nei %1 atributų.
MoveDown=Perkelti žemyn
MoveUp=Perkelti aukštyn
PostingProfileName=Registravimo šablonas
 ;Label for posting profile name
PriceAdjustment=Kainos koregavimas
 ;Label for price adjustment component
PriceAdjustmentAttributes=Kainų atributai kainos koregavimui
 ;Label for price adjustment attributes
PriceAttrbuteSource=Šaltinis
 ;Label for the source of price attributes
PriceAttribute=Kainos atributas
PriceAttributeCatalog=Katalogas
PriceAttributeColor=Spalva
PriceAttributeConfiguration=Konfigūracija
PriceAttributeCustAccountNum=Kliento kodas
PriceAttributeCustGroup=Klientų grupė
PriceAttributeCustMarkupGroup=Kliento išlaidų grupė
PriceAttributeCustSegment=Segmentas
PriceAttributeCustType=Kliento tipas
PriceAttributeDataType=Kainos atributo duomenų tipas
 ;It's not public facing.
PriceAttributeDlvMode=Pristatymo būdas
PriceAttributeDlvModeMarkupGroup=Pristatymo mokesčių grupė
PriceAttributeItemMarkupGroup=Prekės mokesčių grupė
PriceAttributeName=Pavadinimas
 ;Label for the name of price attributes
PriceAttributeProcessStatus=Proceso būsena
 ;Label for price attribute process status
PriceAttributeProduct=Produktas
PriceAttributeProductCategory=Kategorija
PriceAttributeProductVariant=Produkto variantas
PriceAttributeProviderNotFound=%1 kainos atributo teikėjas nerastas.
 ;An error indicating customization is not correct.
PriceAttributeProviderNotSupported=Teikėjas %1 nepalaiko kainos atributo %2.
 ;An error indicating customization is not correct.
PriceAttributePublish=Kainos atributai sėkmingai paskelbti.
PriceAttributeRetailAffiliation=Priskyrimas
PriceAttributeRetailLoyaltyTier=Lojalumo programa
PriceAttributes=Kainos atributai
 ;Label for price attributes form
PriceAttributeSite=Teritorija
PriceAttributeSize=Dydis
PriceAttributeStatus=Kainos atributo būsena
 ;It's not public facing.
PriceAttributeStyle=Stilius
PriceAttributeType=Tipas
 ;Label for price attribute types
PriceAttributeTypeCustomFields=Pasirinktiniai laukai
 ;Label for customization pricing attributes
PriceAttributeTypeEcoResAttribute=Vartotojo nurodyti atributai
 ;Type of an attribute references EcoResAttribute
PriceAttributeTypePredefinedFields=Iš anksto nustatyti laukai
 ;Type of a predefined attribute field
PriceAttributeWarehouse=Sandėlys
PriceComponent=Kainos komponentas
 ;Label for price component
PriceComponentCodeCurrencyMode=Vienalaikiškumo režimas
 ;Label for price component code concurrency mode
PriceComponentCodeName=Kainos komponento kodas
 ;Label for price component code name
PriceComponentCodes=Kainos komponentų kodai
 ;Label for price component codes form
PriceGroupAttributes=Kainų atributai kainų grupėms
 ;Price attributes for price groups
PriceGroupPricingRuleLink=Kainų grupės ir kainodaros taisyklės ryšys
 ;Label for PriceGroupPricingRuleLink table
PriceGroups=Kainų grupės
 ;Label for price group
PricePublishStatus=Publikavimo būsena
PriceTrees=Kainų medžiai
 ;Label for price trees
PricingRuleApplicabilities=Kainos atributo reikšmės
 ;Label for pricing rule applicability
PricingRuleApplicabilityLookupReference=Kainodaros taisyklės taikymo nuorodos
 ;Label for pricing rule applicability references
PricingStructure=Kainodaros struktūra
Product=Produktas
 ;Label for product attribute.
ProductDiscount=Produkto nuolaida
 ;Label for discount component
ProductDiscountAttributes=Kainų atributai produktų nuolaidoms
Published=Publikuota
Publishing=Publikavimas
Rank=Rangas
 ;Priority for price rules.
Rebate=Grąžinimas
 ;Label for rebate component
Revert=Anuliuoti
SalesAgreement=Pardavimo sutartis
SalesOrderHeader=Pardavimo užsakymo antraštė
 ;Label for sales order header attribute.
SalesOrderLine=Pardavimo užsakymo eilutė
 ;Label for sales order line attribute.
SalesTradeAgreement=Pardavimo prekybos sutartis
 ;Label for trade agreement component
ShippingDiscount=Siuntimo nuolaida
ShippingDiscountAttributes=Kainų atributai siuntimo nuolaidoms
TenderDiscount=Mokėjimo priemonės nuolaida
TenderDiscountAttributes=Kainų atributai mokėjimo priemonių nuolaidoms
TradeAgreementAttributes=Kainų atributai prekybos sutartims
 ;Price attributes for trade agreements
UnifiedPricingFeatureLabel=(Nebaigta) Kainodaros valdymas
 ;Feature name for unified pricing management
UnifiedPricingFeatureSummary=Kainodaros valdymo modulis suteikia centralizuotą platformą kainodaros vadybininkams planuoti, konfigūruoti, valdyti, imituoti ir stebėti daugiakanales kainodaros strategijas. Įjungus šią funkciją, organizacijos gali nustatyti lanksčias kainodaros struktūras naudodamos kelis kainų komponentus, pvz., bendrąsias bazines kainas, ilgalaikius sandorius, trumpalaikes reklamas ir retrospektyvius grąžinimus. Kainodaros taisyklės gali būti apibrėžtos pagal produkto, kliento ir užsakymo atributus. Kontekstinė kainodara gali būti pritaikyta skirtingiems segmentams, atsižvelgiant į iš anksto nustatytas sąlygas. Realaus laiko kainodaros apskaičiavimas atliekamas naudojant vieningą kainodaros variklį, kuris nuosekliai veikia tiekimo grandinės, mažmeninės prekybos ir el. prekybos verslo procesuose.
 ;Feature summary for unified pricing management
