Added=Dodano
AttributeWithComponentCode=Nie można usunąć atrybutu ceny, jeśli połączono go z kodem składnika.
AutoCharge=Opłata automatyczna
 ;Label for charge component
BasePrice=Cena podstawowa
CalculationSequence=Sekwencja cen
 ;Label for pricing calculation sequence
CannotDeleteDefaultTree=Nie można usunąć domyślnego drzewa cen.
CannotInsertPriceTree=Dozwolone jest tylko jedno drzewo cen.
Channel=Kanał
 ;Label for channel attribute.
ConcurrencyMode=Tryb współbieżności
Customer=Odbiorca
 ;Label for customer attribute.
DefaultPriceTree=Domyślne drzewo cen
 ;Label for default price tree
Deleted=Usunięto
DeletePriceAttribute=Zamierzasz usunąć rekord w atrybutach ceny. Usunąć go?
Discount=Rabat
 ;Label for discount component
Draft=Wersja robocza
Fields=Pola
MaxAttributeNumber=Nie można zdefiniować więcej niż %1 atrybutów dla składnika ceny.
MoveDown=Przenieś w dół
MoveUp=Przenieś w górę
PostingProfileName=Profil księgowania
 ;Label for posting profile name
PriceAdjustment=Korekta ceny
 ;Label for price adjustment component
PriceAdjustmentAttributes=Atrybuty ceny dla korekt ceny
 ;Label for price adjustment attributes
PriceAttrbuteSource=Źródło
 ;Label for the source of price attributes
PriceAttribute=Atrybut ceny
PriceAttributeCatalog=Wykaz
PriceAttributeColor=Kolor
PriceAttributeConfiguration=Konfiguracja
PriceAttributeCustAccountNum=Konto odbiorcy
PriceAttributeCustGroup=Grupa odbiorców
PriceAttributeCustMarkupGroup=Grupa opłat dla odbiorcy
PriceAttributeCustSegment=Segment
PriceAttributeCustType=Typ odbiorcy
PriceAttributeDataType=Typ danych atrybutu ceny
 ;It's not public facing.
PriceAttributeDlvMode=Metoda dostawy
PriceAttributeDlvModeMarkupGroup=Grupa opłat za dostawę
PriceAttributeItemMarkupGroup=Grupa opłat dla pozycji
PriceAttributeName=Nazwa
 ;Label for the name of price attributes
PriceAttributeProcessStatus=Stan procesu
 ;Label for price attribute process status
PriceAttributeProduct=Produkt
PriceAttributeProductCategory=Kategoria
PriceAttributeProductVariant=Wariant produktu
PriceAttributeProviderNotFound=Nie znaleziono dostawcy atrybutów ceny dla %1.
 ;An error indicating customization is not correct.
PriceAttributeProviderNotSupported=Dostawca %1 nie obsługuje atrybutu ceny %2.
 ;An error indicating customization is not correct.
PriceAttributePublish=Atrybuty ceny zostały opublikowane pomyślnie.
PriceAttributeRetailAffiliation=Przynależność
PriceAttributeRetailLoyaltyTier=Program lojalnościowy
PriceAttributes=Atrybuty ceny
 ;Label for price attributes form
PriceAttributeSite=Oddział
PriceAttributeSize=Rozmiar
PriceAttributeStatus=Stan atrybutu ceny
 ;It's not public facing.
PriceAttributeStyle=Styl
PriceAttributeType=Typ
 ;Label for price attribute types
PriceAttributeTypeCustomFields=Pola niestandardowe
 ;Label for customization pricing attributes
PriceAttributeTypeEcoResAttribute=Atrybuty zdefiniowane przez użytkownika
 ;Type of an attribute references EcoResAttribute
PriceAttributeTypePredefinedFields=Wstępnie zdefiniowane pola
 ;Type of a predefined attribute field
PriceAttributeWarehouse=Magazyn
PriceComponent=Składnik ceny
 ;Label for price component
PriceComponentCodeCurrencyMode=Tryb współbieżności
 ;Label for price component code concurrency mode
PriceComponentCodeName=Kod składnika ceny
 ;Label for price component code name
PriceComponentCodes=Kody składnika ceny
 ;Label for price component codes form
PriceGroupAttributes=Atrybuty ceny dla grup cen
 ;Price attributes for price groups
PriceGroupPricingRuleLink=Powiązanie między grupą cen i regułą cen
 ;Label for PriceGroupPricingRuleLink table
PriceGroups=Grupy cenowe
 ;Label for price group
PricePublishStatus=Stan publikowania
PriceTrees=Drzewa cen
 ;Label for price trees
PricingRuleApplicabilities=Wartości atrybutów ceny
 ;Label for pricing rule applicability
PricingRuleApplicabilityLookupReference=Odwołania do możliwości stosowania reguły cen
 ;Label for pricing rule applicability references
PricingStructure=Struktura cen
Product=Produkt
 ;Label for product attribute.
ProductDiscount=Rabat na produkt
 ;Label for discount component
ProductDiscountAttributes=Atrybuty ceny dla rabatów na produkt
Published=Opublikowane
Publishing=Wydawnictwa
Rank=Stopień
 ;Priority for price rules.
Rebate=Rabat
 ;Label for rebate component
Revert=Przywróć
SalesAgreement=Umowa sprzedaży
SalesOrderHeader=Nagłówek zamówienia sprzedaży
 ;Label for sales order header attribute.
SalesOrderLine=Wiersz zamówienia sprzedaży
 ;Label for sales order line attribute.
SalesTradeAgreement=Umowa handlowa sprzedaży
 ;Label for trade agreement component
ShippingDiscount=Rabat wysyłki
ShippingDiscountAttributes=Atrybuty ceny dla rabatów na wysyłkę
TenderDiscount=Rabat dla metody płatności
TenderDiscountAttributes=Atrybuty ceny dla rabatów na metodę płatności
TradeAgreementAttributes=Atrybuty ceny dla umów handlowych
 ;Price attributes for trade agreements
UnifiedPricingFeatureLabel=(Niekompletne) Zarządzanie cenami
 ;Feature name for unified pricing management
UnifiedPricingFeatureSummary=Moduł Zarządzanie cenami to scentralizowana platforma dla menedżerów cen, która umożliwia planowanie, konfigurowanie, symulację i monitorowanie wielokanałowych strategii dotyczących cen oraz zarządzanie nimi. Po włączeniu tej funkcji organizacje mogą konfigurować elastyczne struktury cen przy użyciu wielu składników cen, takich jak ogólne ceny podstawowe, transakcje długoterminowe, promocje krótkoterminowe i rabaty wsteczne. Reguły dotyczące cen można zdefiniować na podstawie atrybutów produktu, odbiorcy i zamówienia. Ceny kontekstowe można zaimplementować w różnych segmentach w oparciu o wstępnie zdefiniowane warunki. Obliczanie cen w czasie rzeczywistym jest obsługiwane przez ujednolicony aparat wyceny, który działa spójnie w ramach procesów biznesowych łańcucha dostaw, handlu detalicznego oraz handlu elektronicznego.
 ;Feature summary for unified pricing management
