Added=Đã thêm
AttributeWithComponentCode=Bạn không thể xóa thuộc tính giá khi nó được liên kết với mã thành phần.
AutoCharge=Khoản phí tự động
 ;Label for charge component
BasePrice=Giá cơ sở
CalculationSequence=Trình tự định giá
 ;Label for pricing calculation sequence
CannotDeleteDefaultTree=Không thể xóa cây giá mặc định.
CannotInsertPriceTree=Chỉ cho phép một cây giá.
Channel=Kênh
 ;Label for channel attribute.
ConcurrencyMode=Chế độ đồng thời
Customer=Khách hàng
 ;Label for customer attribute.
DefaultPriceTree=Cây giá mặc định
 ;Label for default price tree
Deleted=Đã xóa
DeletePriceAttribute=Bạn sắp xóa bản ghi trong thuộc tính giá. Xóa bản ghi?
Discount=Giảm giá
 ;Label for discount component
Draft=Bản nháp
Fields=Trường
MaxAttributeNumber=Bạn không thể xác định nhiều hơn %1 thuộc tính cho một thành phần giá.
MoveDown=Di chuyển xuống
MoveUp=Di chuyển lên
PostingProfileName=Hồ sơ ghi sổ
 ;Label for posting profile name
PriceAdjustment=Điều chỉnh giá
 ;Label for price adjustment component
PriceAdjustmentAttributes=Thuộc tính giá để điều chỉnh giá
 ;Label for price adjustment attributes
PriceAttrbuteSource=Nguồn
 ;Label for the source of price attributes
PriceAttribute=Thuộc tính giá
PriceAttributeCatalog=Danh mục
PriceAttributeColor=Màu sắc
PriceAttributeConfiguration=Cấu hình
PriceAttributeCustAccountNum=Tài khoản khách hàng
PriceAttributeCustGroup=Nhóm khách hàng
PriceAttributeCustMarkupGroup=Nhóm chi phí khách hàng
PriceAttributeCustSegment=Phân đoạn
PriceAttributeCustType=Loại khách hàng
PriceAttributeDataType=Loại dữ liệu thuộc tính giá
 ;It's not public facing.
PriceAttributeDlvMode=Phương thức giao hàng
PriceAttributeDlvModeMarkupGroup=Nhóm phí giao hàng
PriceAttributeItemMarkupGroup=Nhóm phí mặt hàng
PriceAttributeName=Tên
 ;Label for the name of price attributes
PriceAttributeProcessStatus=Trạng thái xử lý
 ;Label for price attribute process status
PriceAttributeProduct=Sản phẩm
PriceAttributeProductCategory=Thể loại
PriceAttributeProductVariant=Mẫu mã sản phẩm
PriceAttributeProviderNotFound=Không tìm thấy nhà cung cấp thuộc tính giá nào cho %1.
 ;An error indicating customization is not correct.
PriceAttributeProviderNotSupported=Nhà cung cấp %1 không hỗ trợ thuộc tính giá %2.
 ;An error indicating customization is not correct.
PriceAttributePublish=Thuộc tính giá đã được xuất bản thành công.
PriceAttributeRetailAffiliation=Liên kết
PriceAttributeRetailLoyaltyTier=Chương trình khách hàng thân thiết
PriceAttributes=Thuộc tính giá
 ;Label for price attributes form
PriceAttributeSite=Trang
PriceAttributeSize=Kích cỡ
PriceAttributeStatus=Trạng thái thuộc tính giá
 ;It's not public facing.
PriceAttributeStyle=Kiểu cách
PriceAttributeType=Hình thức
 ;Label for price attribute types
PriceAttributeTypeCustomFields=Trường tùy chỉnh
 ;Label for customization pricing attributes
PriceAttributeTypeEcoResAttribute=Thuộc tính do người dùng xác định
 ;Type of an attribute references EcoResAttribute
PriceAttributeTypePredefinedFields=Trường xác định trước
 ;Type of a predefined attribute field
PriceAttributeWarehouse=Kho hàng
PriceComponent=Thành phần giá
 ;Label for price component
PriceComponentCodeCurrencyMode=Chế độ đồng thời
 ;Label for price component code concurrency mode
PriceComponentCodeName=Mã thành phần giá
 ;Label for price component code name
PriceComponentCodes=Mã thành phần giá
 ;Label for price component codes form
PriceGroupAttributes=Thuộc tính giá cho nhóm giá
 ;Price attributes for price groups
PriceGroupPricingRuleLink=Mối liên hệ giữa nhóm giá và quy tắc định giá
 ;Label for PriceGroupPricingRuleLink table
PriceGroups=Nhóm giá
 ;Label for price group
PricePublishStatus=Trạng thái phát hành
PriceTrees=Cây giá
 ;Label for price trees
PricingRuleApplicabilities=Giá trị thuộc tính giá
 ;Label for pricing rule applicability
PricingRuleApplicabilityLookupReference=Tham chiếu khả năng áp dụng quy tắc định giá
 ;Label for pricing rule applicability references
PricingStructure=Cấu trúc định giá
Product=Sản phẩm
 ;Label for product attribute.
ProductDiscount=Chiết khấu sản phẩm
 ;Label for discount component
ProductDiscountAttributes=Thuộc tính giá để giảm giá sản phẩm
Published=Đã phát hành
Publishing=Xuất bản
Rank=Xếp hạng
 ;Priority for price rules.
Rebate=Ưu đãi hoàn tiền
 ;Label for rebate component
Revert=Hoàn nguyên
SalesAgreement=Thỏa thuận bán hàng
SalesOrderHeader=Tiêu đề đơn đặt hàng bán
 ;Label for sales order header attribute.
SalesOrderLine=Dòng đơn đặt hàng bán
 ;Label for sales order line attribute.
SalesTradeAgreement=Thỏa thuận thương mại bán hàng
 ;Label for trade agreement component
ShippingDiscount=Giảm giá vận chuyển
ShippingDiscountAttributes=Thuộc tính giá để giảm giá vận chuyển
TenderDiscount=Chiết khấu theo loại tiền thu
TenderDiscountAttributes=Thuộc tính giá để cho chiết khấu theo loại tiền thu
TradeAgreementAttributes=Thuộc tính giá cho thỏa thuận thương mại
 ;Price attributes for trade agreements
UnifiedPricingFeatureLabel=(Chưa hoàn tất) Quản lý định giá
 ;Feature name for unified pricing management
UnifiedPricingFeatureSummary=Mô đun quản lý giá cung cấp một nền tảng trung tâm để các nhà quản lý giá lên kế hoạch, đặt cấu hình, quản lý, mô phỏng và theo dõi các chiến lược giá bán hàng đa kênh. Với tính năng này được kích hoạt, các tổ chức có thể thiết lập cấu trúc giá linh hoạt bằng cách sử dụng nhiều thành phần giá khác nhau như giá cơ sở chung, thỏa thuận dài hạn, khuyến mại ngắn hạn và ưu đãi hoàn tiền hồi tố. Các quy tắc về giá có thể được xác định dựa trên các thuộc tính của sản phẩm, khách hàng và đơn hàng. Giá theo ngữ cảnh có thể được triển khai cho các phân khúc khác nhau dựa trên các điều kiện được xác định trước. Việc tính toán giá theo thời gian thực được hỗ trợ bởi công cụ tính giá thống nhất hoạt động xuyên suốt chuỗi cung ứng, quy trình nghiệp vụ bán lẻ và thương mại điện tử.
 ;Feature summary for unified pricing management
