Added=已添加
AttributeWithComponentCode=当价格属性与构成代码关联时，无法将其删除。
AutoCharge=自动费用
 ;Label for charge component
BasePrice=基价
CalculationSequence=定价顺序
 ;Label for pricing calculation sequence
CannotDeleteDefaultTree=无法删除默认价格树。
CannotInsertPriceTree=仅允许一个价格树。
Channel=渠道
 ;Label for channel attribute.
ConcurrencyMode=并用模式
Customer=客户
 ;Label for customer attribute.
DefaultPriceTree=默认价格树
 ;Label for default price tree
Deleted=已删除
DeletePriceAttribute=您将要删除价格属性中的一条记录。是否删除记录?
Discount=折扣
 ;Label for discount component
Draft=草稿
Fields=字段
MaxAttributeNumber=无法为价格构成定义超过 %1 个属性。
MoveDown=下移
MoveUp=上移
PostingProfileName=过帐模板
 ;Label for posting profile name
PriceAdjustment=价格调整
 ;Label for price adjustment component
PriceAdjustmentAttributes=价格调整的价格属性
 ;Label for price adjustment attributes
PriceAttrbuteSource=源
 ;Label for the source of price attributes
PriceAttribute=价格属性
PriceAttributeCatalog=目录
PriceAttributeColor=颜色
PriceAttributeConfiguration=配置
PriceAttributeCustAccountNum=客户帐户
PriceAttributeCustGroup=客户组
PriceAttributeCustMarkupGroup=客户费用组
PriceAttributeCustSegment=客户细分
PriceAttributeCustType=客户类型
PriceAttributeDataType=价格属性数据类型
 ;It's not public facing.
PriceAttributeDlvMode=交货模式
PriceAttributeDlvModeMarkupGroup=交货费用组
PriceAttributeItemMarkupGroup=物料费用组
PriceAttributeName=名称
 ;Label for the name of price attributes
PriceAttributeProcessStatus=流程状态
 ;Label for price attribute process status
PriceAttributeProduct=产品
PriceAttributeProductCategory=类别
PriceAttributeProductVariant=产品变型
PriceAttributeProviderNotFound=找不到 %1 的任何价格属性提供程序。
 ;An error indicating customization is not correct.
PriceAttributeProviderNotSupported=提供程序 %1 不支持价格属性 %2。
 ;An error indicating customization is not correct.
PriceAttributePublish=价格属性已成功发布。
PriceAttributeRetailAffiliation=隶属关系
PriceAttributeRetailLoyaltyTier=会员计划
PriceAttributes=价格属性
 ;Label for price attributes form
PriceAttributeSite=站点
PriceAttributeSize=大小
PriceAttributeStatus=价格属性状态
 ;It's not public facing.
PriceAttributeStyle=样式
PriceAttributeType=类型
 ;Label for price attribute types
PriceAttributeTypeCustomFields=自定义字段
 ;Label for customization pricing attributes
PriceAttributeTypeEcoResAttribute=用户定义的属性
 ;Type of an attribute references EcoResAttribute
PriceAttributeTypePredefinedFields=预定义字段
 ;Type of a predefined attribute field
PriceAttributeWarehouse=仓库
PriceComponent=价格构成
 ;Label for price component
PriceComponentCodeCurrencyMode=并用模式
 ;Label for price component code concurrency mode
PriceComponentCodeName=价格构成代码
 ;Label for price component code name
PriceComponentCodes=价格构成代码
 ;Label for price component codes form
PriceGroupAttributes=价格组的价格属性
 ;Price attributes for price groups
PriceGroupPricingRuleLink=价格组与定价规则之间的链接
 ;Label for PriceGroupPricingRuleLink table
PriceGroups=价格组
 ;Label for price group
PricePublishStatus=发布状态
PriceTrees=价格树
 ;Label for price trees
PricingRuleApplicabilities=价格属性值
 ;Label for pricing rule applicability
PricingRuleApplicabilityLookupReference=定价规则适用性引用
 ;Label for pricing rule applicability references
PricingStructure=定价结构
Product=产品
 ;Label for product attribute.
ProductDiscount=产品折扣
 ;Label for discount component
ProductDiscountAttributes=产品折扣的价格属性
Published=已发布
Publishing=发布
Rank=排名
 ;Priority for price rules.
Rebate=返点
 ;Label for rebate component
Revert=还原
SalesAgreement=销售协议
SalesOrderHeader=销售订单标头
 ;Label for sales order header attribute.
SalesOrderLine=销售订单行
 ;Label for sales order line attribute.
SalesTradeAgreement=销售贸易协议
 ;Label for trade agreement component
ShippingDiscount=装运折扣
ShippingDiscountAttributes=装运折扣的价格属性
TenderDiscount=支付方式折扣
TenderDiscountAttributes=支付方式折扣的价格属性
TradeAgreementAttributes=贸易协议的价格属性
 ;Price attributes for trade agreements
UnifiedPricingFeatureLabel=(不完整)定价管理
 ;Feature name for unified pricing management
UnifiedPricingFeatureSummary=定价管理模块为定价经理提供了一个集中式平台来计划、配置、管理、模拟和监控全渠道定价策略。启用此功能后，组织可以使用多个价格构成(例如常规基价、长期交易、短期促销和追溯返点)设置灵活的定价结构。可以基于产品、客户和订单属性定义定价规则。可以基于预定义条件向不同客户细分推出情境定价。实时定价计算由统一的定价引擎提供支持，此引擎可在供应链、零售和电子商务业务流程中一致地运行。
 ;Feature summary for unified pricing management
