Added=Lisätty
AttributeWithComponentCode=Hintamääritettä ei voi poistaa, kun se on linkitetty komponenttikoodiin.
AutoCharge=Automaattinen veloitus
 ;Label for charge component
BasePrice=Perushinta
CalculationSequence=Hinnoittelujärjestys
 ;Label for pricing calculation sequence
CannotDeleteDefaultTree=Oletushintapuuta ei voi poistaa.
CannotInsertPriceTree=Vain yksi hintapuu on sallittu.
Channel=Kanava
 ;Label for channel attribute.
ConcurrencyMode=Samanaikaisuustila
Customer=Asiakas
 ;Label for customer attribute.
DefaultPriceTree=Oletushintapuu
 ;Label for default price tree
Deleted=Poistettu
DeletePriceAttribute=Olet poistamassa tietueen hintamääritteistä. Poistetaanko tietue?
Discount=Alennus
 ;Label for discount component
Draft=Luonnos
Fields=Kentät
MaxAttributeNumber=Hintakomponentille voi määrittää enintään %1 määritettä.
MoveDown=Siirry alaspäin
MoveUp=Siirry ylöspäin
PostingProfileName=Kirjausprofiili
 ;Label for posting profile name
PriceAdjustment=Hinnanoikaisu
 ;Label for price adjustment component
PriceAdjustmentAttributes=Hinnanoikaisujen hintamääritteet
 ;Label for price adjustment attributes
PriceAttrbuteSource=Lähde
 ;Label for the source of price attributes
PriceAttribute=Hintamäärite
PriceAttributeCatalog=Luettelo
PriceAttributeColor=Väri
PriceAttributeConfiguration=Määritys
PriceAttributeCustAccountNum=Asiakastili
PriceAttributeCustGroup=Asiakasryhmä
PriceAttributeCustMarkupGroup=Asiakkaan kulujen ryhmä
PriceAttributeCustSegment=Segmentti
PriceAttributeCustType=Asiakastyyppi
PriceAttributeDataType=Hintamääritteen tietotyyppi
 ;It's not public facing.
PriceAttributeDlvMode=Toimitustapa
PriceAttributeDlvModeMarkupGroup=Toimituksen kuluryhmä
PriceAttributeItemMarkupGroup=Nimikkeen kulujen ryhmä
PriceAttributeName=Nimi
 ;Label for the name of price attributes
PriceAttributeProcessStatus=Prosessin tila
 ;Label for price attribute process status
PriceAttributeProduct=Tuote
PriceAttributeProductCategory=Luokka
PriceAttributeProductVariant=Tuotevariantti
PriceAttributeProviderNotFound=Kohteelle %1 ei löydy hintamääritepalvelua.
 ;An error indicating customization is not correct.
PriceAttributeProviderNotSupported=Palvelu ei %1 tue hintamääritettä %2.
 ;An error indicating customization is not correct.
PriceAttributePublish=Hintamääritteiden julkaisu onnistui.
PriceAttributeRetailAffiliation=Liitos
PriceAttributeRetailLoyaltyTier=Kanta-asiakasohjelma
PriceAttributes=Hintamääritteet
 ;Label for price attributes form
PriceAttributeSite=Toimipaikka
PriceAttributeSize=Koko
PriceAttributeStatus=Hintamääriteryhmän tila
 ;It's not public facing.
PriceAttributeStyle=Tyyli
PriceAttributeType=Tyyppi
 ;Label for price attribute types
PriceAttributeTypeCustomFields=Mukautetut kentät
 ;Label for customization pricing attributes
PriceAttributeTypeEcoResAttribute=Käyttäjän määrittämät määritteet
 ;Type of an attribute references EcoResAttribute
PriceAttributeTypePredefinedFields=Ennalta määritetyt kentät
 ;Type of a predefined attribute field
PriceAttributeWarehouse=Fyysinen varasto
PriceComponent=Hintakomponentti
 ;Label for price component
PriceComponentCodeCurrencyMode=Samanaikaisuustila
 ;Label for price component code concurrency mode
PriceComponentCodeName=Hintakomponentin koodi
 ;Label for price component code name
PriceComponentCodes=Hintakomponentin koodit
 ;Label for price component codes form
PriceGroupAttributes=Hintaryhmien hintamääritteet
 ;Price attributes for price groups
PriceGroupPricingRuleLink=Hintaryhmän ja hinnoittelusäännön välinen linkki
 ;Label for PriceGroupPricingRuleLink table
PriceGroups=Hintaryhmät
 ;Label for price group
PricePublishStatus=Julkaisun tila
PriceTrees=Hintapuut
 ;Label for price trees
PricingRuleApplicabilities=Hintamääritearvot
 ;Label for pricing rule applicability
PricingRuleApplicabilityLookupReference=Hinnoittelusäännön soveltuvuuden viitteet
 ;Label for pricing rule applicability references
PricingStructure=Hinnoittelurakenne
Product=Tuote
 ;Label for product attribute.
ProductDiscount=Tuotealennus
 ;Label for discount component
ProductDiscountAttributes=Tuotealennusten hintamääritteet
Published=Julkaistu
Publishing=Julkaiseminen
Rank=Sijoitus
 ;Priority for price rules.
Rebate=Ostohyvitys
 ;Label for rebate component
Revert=Palauta
SalesAgreement=Myyntisopimus
SalesOrderHeader=Myyntitilauksen otsikko
 ;Label for sales order header attribute.
SalesOrderLine=Myyntitilausrivi
 ;Label for sales order line attribute.
SalesTradeAgreement=Myyntikauppasopimus
 ;Label for trade agreement component
ShippingDiscount=Lähetyksen alennus
ShippingDiscountAttributes=Lähetysten alennusten hintamääritteet
TenderDiscount=Maksuvälinealennus
TenderDiscountAttributes=Maksuvälinealennusten hintamääritteet
TradeAgreementAttributes=Kauppasopimusten hintamääritteet
 ;Price attributes for trade agreements
UnifiedPricingFeatureLabel=(Keskeneräinen) Hinnoittelun hallinta
 ;Feature name for unified pricing management
UnifiedPricingFeatureSummary=Hinnoittelun hallintamoduuli on keskitetty ympäristö hinnoittelupäälliköille monikanavaisten hinnoittelustrategioiden suunnittelua, määritystä, hallintaa, simulointia ja seuraamista varten. Kun tämä ominaisuus on käytössä, organisaatiot voivat määrittää joustavia hinnoittelurakenteita käyttäen useita hintakomponentteja, kuten yleisiä perushintoja, pitkäaikaisia sopimuksia, lyhytaikaisia kampanjoita ja takautuvia ostohyvityksiä. Hinnoittelusääntöjä voidaan määrittää tuote-, asiakas- ja tilausmääritteiden perusteella. Kontekstiperusteista hinnoittelua voidaan soveltaa eri segmentteihin esimääritettyjen ehtojen perusteella. Reaaliaikainen hinnoittelun laskenta perustuu yhdistetyn hinnoittelun moduuliin, joka toimii johdonmukaisesti toimitusketjun, vähittäismyynnin ja sähköisen kaupankäynnin eri liiketoimintaprosesseissa.
 ;Feature summary for unified pricing management
