Added=Tilføjet
AttributeWithComponentCode=Du kan ikke slette en prisattribut, når den er knyttet til en komponentkode.
AutoCharge=Automatisk gebyr
 ;Label for charge component
BasePrice=Basispris
CalculationSequence=Prisrækkefølge
 ;Label for pricing calculation sequence
CannotDeleteDefaultTree=Standardpristræet kan ikke slettes.
CannotInsertPriceTree=Kun ét pristræ er tilladt.
Channel=Salgskanal
 ;Label for channel attribute.
ConcurrencyMode=Samtidighedstilstand
Customer=Debitor
 ;Label for customer attribute.
DefaultPriceTree=Standardpristræ
 ;Label for default price tree
Deleted=Slettet
DeletePriceAttribute=Du er ved at slette en post i prisattributter. Vil du slette posten?
Discount=Rabat
 ;Label for discount component
Draft=Kladde
Fields=Felter
MaxAttributeNumber=Du kan ikke definere mere end %1 attributter for en priskomponent.
MoveDown=Flyt ned
MoveUp=Flyt op
PostingProfileName=Bogføringsprofil
 ;Label for posting profile name
PriceAdjustment=Prisjustering
 ;Label for price adjustment component
PriceAdjustmentAttributes=Prisattributter for prisjusteringer
 ;Label for price adjustment attributes
PriceAttrbuteSource=Kilde
 ;Label for the source of price attributes
PriceAttribute=Prisattribut
PriceAttributeCatalog=Katalog
PriceAttributeColor=Farve
PriceAttributeConfiguration=Konfiguration
PriceAttributeCustAccountNum=Debitorkonto
PriceAttributeCustGroup=Debitorgruppe
PriceAttributeCustMarkupGroup=Debitorgebyrgruppe
PriceAttributeCustSegment=Segment
PriceAttributeCustType=Debitortype
PriceAttributeDataType=Datatype for prisattribut
 ;It's not public facing.
PriceAttributeDlvMode=Leveringsmåde
PriceAttributeDlvModeMarkupGroup=Leveringsgebyrgruppe
PriceAttributeItemMarkupGroup=Varegebyrgruppe
PriceAttributeName=Navn
 ;Label for the name of price attributes
PriceAttributeProcessStatus=Processtatus
 ;Label for price attribute process status
PriceAttributeProduct=Produkt
PriceAttributeProductCategory=Kategori
PriceAttributeProductVariant=Produktvariant
PriceAttributeProviderNotFound=Der blev ikke fundet nogen prisattributudbyder for %1.
 ;An error indicating customization is not correct.
PriceAttributeProviderNotSupported=Udbyderen %1 understøtter ikke prisattributten %2.
 ;An error indicating customization is not correct.
PriceAttributePublish=Prisattributterne er blevet publiceret.
PriceAttributeRetailAffiliation=Tilknytning
PriceAttributeRetailLoyaltyTier=Fordelskundeprogram
PriceAttributes=Prisattributter
 ;Label for price attributes form
PriceAttributeSite=Lokation
PriceAttributeSize=Størrelse
PriceAttributeStatus=Status for prisattribut
 ;It's not public facing.
PriceAttributeStyle=Stil
PriceAttributeType=Type
 ;Label for price attribute types
PriceAttributeTypeCustomFields=Brugerdefinerede felter
 ;Label for customization pricing attributes
PriceAttributeTypeEcoResAttribute=Brugerdefinerede attributter
 ;Type of an attribute references EcoResAttribute
PriceAttributeTypePredefinedFields=Foruddefinerede felter
 ;Type of a predefined attribute field
PriceAttributeWarehouse=Lagersted
PriceComponent=Priskomponent
 ;Label for price component
PriceComponentCodeCurrencyMode=Samtidighedstilstand
 ;Label for price component code concurrency mode
PriceComponentCodeName=Priskomponentkode
 ;Label for price component code name
PriceComponentCodes=Priskomponentkoder
 ;Label for price component codes form
PriceGroupAttributes=Prisgrupper for prisjusteringer
 ;Price attributes for price groups
PriceGroupPricingRuleLink=Link mellem prisgruppe og prissætningsregel
 ;Label for PriceGroupPricingRuleLink table
PriceGroups=Prisgrupper
 ;Label for price group
PricePublishStatus=Publiceringsstatus
PriceTrees=Pristræer
 ;Label for price trees
PricingRuleApplicabilities=Prisattributværdier
 ;Label for pricing rule applicability
PricingRuleApplicabilityLookupReference=Reference til prisregelanvendelse
 ;Label for pricing rule applicability references
PricingStructure=Prissætningsstruktur
Product=Produkt
 ;Label for product attribute.
ProductDiscount=Produktrabat
 ;Label for discount component
ProductDiscountAttributes=Prisattributter for produktrabatter
Published=Publiceret
Publishing=Forlagsbranchen
Rank=Rangering
 ;Priority for price rules.
Rebate=Rabat
 ;Label for rebate component
Revert=Gendan
SalesAgreement=Salgsaftale
SalesOrderHeader=Salgsordreoverskrift
 ;Label for sales order header attribute.
SalesOrderLine=Salgsordrelinje
 ;Label for sales order line attribute.
SalesTradeAgreement=Samhandelsaftale
 ;Label for trade agreement component
ShippingDiscount=Forsendelsesrabat
ShippingDiscountAttributes=Prisattributter for forsendelsesrabatter
TenderDiscount=Rabat med betalingsmiddel
TenderDiscountAttributes=Prisattributter for rabatter med betalingsmiddel
TradeAgreementAttributes=Prisattributter for samhandelsaftaler
 ;Price attributes for trade agreements
UnifiedPricingFeatureLabel=(Ufuldstændig) Prisstyring
 ;Feature name for unified pricing management
UnifiedPricingFeatureSummary=Modulet Prisstyring tilbyder en central platform, hvor prissætningschefer kan planlægge, konfigurere, administrere, simulere og overvåge omnikanal-prissætningsstrategier. Når denne funktion er aktiveret, kan organisationer konfigurere fleksible prissætningsstrukturer vha. flere priskomponenter som f.eks. generelle grundpriser, langsigtede aftaler, kortsigtede kampagner og retrospektive rabatter. Prissætningsregler kan defineres på basis af produkt-, debitor- og ordreattributter. Kontekstafhængig prissætning kan udrulles til forskellige segmenter baseret på foruddefinerede betingelser. Prissætningsberegning i realtid styres af et samlet prissætningsprogram, der arbejder på tværs af forretningsprocesser for forsyningskæder, detail og e-handel.
 ;Feature summary for unified pricing management
