Added=Προστέθηκε
AttributeWithComponentCode=Δεν μπορείτε να διαγράψετε ένα χαρακτηριστικό τιμής όταν είναι συνδεδεμένο με έναν κωδικό στοιχείου.
AutoCharge=Αυτόματη χρέωση
 ;Label for charge component
BasePrice=Βασική τιμή
CalculationSequence=Ακολουθία τιμολόγησης
 ;Label for pricing calculation sequence
CannotDeleteDefaultTree=Δεν είναι δυνατή η διαγραφή του προεπιλεγμένου δέντρου τιμών.
CannotInsertPriceTree=Επιτρέπεται μόνο ένα δέντρο τιμών.
Channel=Κανάλι
 ;Label for channel attribute.
ConcurrencyMode=Λειτουργία ταυτόχρονης εκτέλεσης
Customer=Πελάτης
 ;Label for customer attribute.
DefaultPriceTree=Προεπιλεγμένο δέντρων τιμών
 ;Label for default price tree
Deleted=Διαγράφηκε
DeletePriceAttribute=Πρόκειται να διαγράψετε μια καρτέλα στα χαρακτηριστικά τιμών. Διαγραφή καρτέλας;
Discount=Έκπτωση
 ;Label for discount component
Draft=Προσχέδιο
Fields=Πεδία
MaxAttributeNumber=Δεν μπορείτε να ορίσετε περισσότερα από %1 χαρακτηριστικά για ένα στοιχείο τιμής.
MoveDown=Μετακίνηση προς τα κάτω
MoveUp=Μετακίνηση προς τα επάνω
PostingProfileName=Προφίλ δημοσίευσης
 ;Label for posting profile name
PriceAdjustment=Προσαρμογή τιμής
 ;Label for price adjustment component
PriceAdjustmentAttributes=Χαρακτηριστικά τιμής για προσαρμογές τιμών
 ;Label for price adjustment attributes
PriceAttrbuteSource=Προέλευση
 ;Label for the source of price attributes
PriceAttribute=Χαρακτηριστικό τιμής
PriceAttributeCatalog=Κατάλογος
PriceAttributeColor=Χρώμα
PriceAttributeConfiguration=Παράμετροι
PriceAttributeCustAccountNum=Λογαριασμός πελάτη
PriceAttributeCustGroup=Ομάδα πελατών
PriceAttributeCustMarkupGroup=Ομάδα χρεώσεων πελατών
PriceAttributeCustSegment=Τμήμα
PriceAttributeCustType=Τύπος πελάτη
PriceAttributeDataType=Τύπος δεδομένων χαρακτηριστικών τιμής
 ;It's not public facing.
PriceAttributeDlvMode=Τρόπος παράδοσης
PriceAttributeDlvModeMarkupGroup=Ομάδα χρεώσεων παράδοσης
PriceAttributeItemMarkupGroup=Ομάδα χρεώσεων στοιχείου
PriceAttributeName=Όνομα
 ;Label for the name of price attributes
PriceAttributeProcessStatus=Κατάσταση διεργασίας
 ;Label for price attribute process status
PriceAttributeProduct=Προϊόν
PriceAttributeProductCategory=Κατηγορία
PriceAttributeProductVariant=Παραλλαγή προϊόντος
PriceAttributeProviderNotFound=Δεν βρέθηκε πάροχος χαρακτηριστικών τιμής για %1.
 ;An error indicating customization is not correct.
PriceAttributeProviderNotSupported=Ο πάροχος %1 δεν υποστηρίζει το χαρακτηριστικό τιμής %2.
 ;An error indicating customization is not correct.
PriceAttributePublish=Τα χαρακτηριστικά τιμής έχουν δημοσιευτεί με επιτυχία.
PriceAttributeRetailAffiliation=Συνεργασία
PriceAttributeRetailLoyaltyTier=Πρόγραμμα ανταμοιβών
PriceAttributes=Χαρακτηριστικά τιμών
 ;Label for price attributes form
PriceAttributeSite=Τοποθεσία
PriceAttributeSize=Μέγεθος
PriceAttributeStatus=Κατάσταση χαρακτηριστικών τιμών
 ;It's not public facing.
PriceAttributeStyle=Στυλ
PriceAttributeType=Τύπος
 ;Label for price attribute types
PriceAttributeTypeCustomFields=Προσαρμοσμένα πεδία
 ;Label for customization pricing attributes
PriceAttributeTypeEcoResAttribute=Χαρακτηριστικά που καθορίζονται από τον χρήστη
 ;Type of an attribute references EcoResAttribute
PriceAttributeTypePredefinedFields=Προκαθορισμένα πεδία
 ;Type of a predefined attribute field
PriceAttributeWarehouse=Αποθήκη
PriceComponent=Στοιχείο τιμής
 ;Label for price component
PriceComponentCodeCurrencyMode=Λειτουργία ταυτόχρονης εκτέλεσης
 ;Label for price component code concurrency mode
PriceComponentCodeName=Κωδικός στοιχείου τιμής
 ;Label for price component code name
PriceComponentCodes=Κωδικοί στοιχείου τιμής
 ;Label for price component codes form
PriceGroupAttributes=Χαρακτηριστικά τιμής για ομάδες τιμών
 ;Price attributes for price groups
PriceGroupPricingRuleLink=Σύνδεση μεταξύ της ομάδας τιμών και του κανόνα τιμολόγησης
 ;Label for PriceGroupPricingRuleLink table
PriceGroups=Ομάδες τιμών
 ;Label for price group
PricePublishStatus=Κατάσταση δημοσίευσης
PriceTrees=Δέντρα τιμών
 ;Label for price trees
PricingRuleApplicabilities=Τιμές χαρακτηριστικών τιμής
 ;Label for pricing rule applicability
PricingRuleApplicabilityLookupReference=Αναφορές εφαρμοσιμότητας κανόνων τιμολόγησης
 ;Label for pricing rule applicability references
PricingStructure=Δομή τιμολόγησης
Product=Προϊόν
 ;Label for product attribute.
ProductDiscount=Έκπτωση προϊόντος
 ;Label for discount component
ProductDiscountAttributes=Χαρακτηριστικά τιμών για εκπτώσεις προϊόντων
Published=Δημοσιεύτηκε
Publishing=Δημοσίευση
Rank=Κατάταξη
 ;Priority for price rules.
Rebate=Επιστροφή
 ;Label for rebate component
Revert=Επαναφορά
SalesAgreement=Σύμβαση πώλησης
SalesOrderHeader=Κεφαλίδα εντολής πώλησης
 ;Label for sales order header attribute.
SalesOrderLine=Γραμμή εντολής πώλησης
 ;Label for sales order line attribute.
SalesTradeAgreement=Εμπορική συμφωνία πωλήσεων
 ;Label for trade agreement component
ShippingDiscount=Έκπτωση αποστολής
ShippingDiscountAttributes=Χαρακτηριστικά τιμών για εκπτώσεις αποστολής
TenderDiscount=Έκπτωση προσφοράς
TenderDiscountAttributes=Χαρακτηριστικά τιμών για εκπτώσεις προσφοράς
TradeAgreementAttributes=Χαρακτηριστικά τιμής για εμπορικές συμβάσεις
 ;Price attributes for trade agreements
UnifiedPricingFeatureLabel=(Ελλιπές) Διαχείριση τιμολόγησης
 ;Feature name for unified pricing management
UnifiedPricingFeatureSummary=Η ενότητα διαχείρισης τιμολόγησης παρέχει μια κεντρική πλατφόρμα για τους διαχειριστές τιμολόγησης για τον σχεδιασμό, τη διαμόρφωση, τη διαχείριση, την προσομοίωση και την παρακολούθηση στρατηγικών τιμολόγησης πανκαναλικού. Με ενεργοποιημένη αυτήν τη δυνατότητα, οι οργανισμοί μπορούν να δημιουργήσουν ευέλικτες δομές τιμολόγησης χρησιμοποιώντας πολλαπλά στοιχεία τιμών, όπως γενικές τιμές βάσης, μακροπρόθεσμες συμφωνίες, βραχυπρόθεσμες προσφορές και αναδρομικές επιστροφές. Οι κανόνες τιμολόγησης μπορούν να οριστούν με βάση τα χαρακτηριστικά του προϊόντος, του πελάτη και της εντολής. Η τιμολόγηση με βάση τα συμφραζόμενα μπορεί να αναπτυχθεί σε διαφορετικά τμήματα με βάση προκαθορισμένες συνθήκες. Ο υπολογισμός τιμολόγησης σε πραγματικό χρόνο τροφοδοτείται από μια ενοποιημένη μηχανή τιμολόγησης που λειτουργεί με συνέπεια στις επιχειρηματικές διαδικασίες της αλυσίδας εφοδιασμού, του λιανικού εμπορίου και του ηλεκτρονικού εμπορίου.
 ;Feature summary for unified pricing management
