Added=Pievienots
AttributeWithComponentCode=Cenas atribūtu nevar izdzēst, ja tas ir saistīts ar komponenta kodu.
AutoCharge=Automātiskā maksa
 ;Label for charge component
BasePrice=Pamatcena
CalculationSequence=Cenu noteikšanas secība
 ;Label for pricing calculation sequence
CannotDeleteDefaultTree=Noklusējuma cenu koku nevar izdzēst.
CannotInsertPriceTree=Ir atļauts tikai viens cenu koks.
Channel=Kanāls
 ;Label for channel attribute.
ConcurrencyMode=Vienlaicīguma režīms
Customer=Debitors
 ;Label for customer attribute.
DefaultPriceTree=Noklusējuma cenu koks
 ;Label for default price tree
Deleted=Izdzēsta
DeletePriceAttribute=Jūs gatavojaties izdzēst ierakstu cenu atribūtos. Vai izdzēst ierakstu?
Discount=Atlaide
 ;Label for discount component
Draft=Melnraksts
Fields=Lauki
MaxAttributeNumber=Cenas komponentam nevar definēt vairāk par %1 atribūtiem.
MoveDown=Pārvietot uz leju
MoveUp=Pārvietot uz augšu
PostingProfileName=Grāmatošanas profils
 ;Label for posting profile name
PriceAdjustment=Cenas korekcija
 ;Label for price adjustment component
PriceAdjustmentAttributes=Cenu atribūti cenu korekcijām
 ;Label for price adjustment attributes
PriceAttrbuteSource=Avots
 ;Label for the source of price attributes
PriceAttribute=Cenas atribūts
PriceAttributeCatalog=Katalogs
PriceAttributeColor=Krāsa
PriceAttributeConfiguration=Konfigurācija
PriceAttributeCustAccountNum=Debitora konts
PriceAttributeCustGroup=Debitoru grupa
PriceAttributeCustMarkupGroup=Debitoru papildmaksu grupa
PriceAttributeCustSegment=Segments
PriceAttributeCustType=Debitora veids
PriceAttributeDataType=Cenas atribūta datu veids
 ;It's not public facing.
PriceAttributeDlvMode=Piegādes veids
PriceAttributeDlvModeMarkupGroup=Piegādes maksu grupa
PriceAttributeItemMarkupGroup=Krājumu maksu grupa
PriceAttributeName=Vārds, uzvārds/nosaukums
 ;Label for the name of price attributes
PriceAttributeProcessStatus=Apstrādes statuss
 ;Label for price attribute process status
PriceAttributeProduct=Prece
PriceAttributeProductCategory=Kategorija
PriceAttributeProductVariant=Preces variants
PriceAttributeProviderNotFound=Šim nav atrasts neviens cenas atribūta nodrošinātājs: %1.
 ;An error indicating customization is not correct.
PriceAttributeProviderNotSupported=Nodrošinātājs %1 neatbalsta cenas atribūtu %2.
 ;An error indicating customization is not correct.
PriceAttributePublish=Cenu atribūti ir sekmīgi publicēti.
PriceAttributeRetailAffiliation=Piederība
PriceAttributeRetailLoyaltyTier=Lojalitātes programma
PriceAttributes=Cenas atribūti
 ;Label for price attributes form
PriceAttributeSite=Atrašanās vieta
PriceAttributeSize=Izmēri
PriceAttributeStatus=Cenas atribūta statuss
 ;It's not public facing.
PriceAttributeStyle=Stils
PriceAttributeType=Tips
 ;Label for price attribute types
PriceAttributeTypeCustomFields=Pielāgoti lauki
 ;Label for customization pricing attributes
PriceAttributeTypeEcoResAttribute=Lietotāja definēti atribūti
 ;Type of an attribute references EcoResAttribute
PriceAttributeTypePredefinedFields=Iepriekš definēti lauki
 ;Type of a predefined attribute field
PriceAttributeWarehouse=Noliktava
PriceComponent=Cenas komponents
 ;Label for price component
PriceComponentCodeCurrencyMode=Vienlaicīguma režīms
 ;Label for price component code concurrency mode
PriceComponentCodeName=Cenas komponenta kods
 ;Label for price component code name
PriceComponentCodes=Cenu komponentu kodi
 ;Label for price component codes form
PriceGroupAttributes=Cenu atribūti cenu grupām
 ;Price attributes for price groups
PriceGroupPricingRuleLink=Saikne starp cenu grupu un cenu noteikšanas kārtulu
 ;Label for PriceGroupPricingRuleLink table
PriceGroups=Cenu grupas
 ;Label for price group
PricePublishStatus=Publicēšanas statuss
PriceTrees=Cenu koki
 ;Label for price trees
PricingRuleApplicabilities=Cenu atribūtu vērtības
 ;Label for pricing rule applicability
PricingRuleApplicabilityLookupReference=Cenu noteikšanas kārtulu lietojamības atsauces
 ;Label for pricing rule applicability references
PricingStructure=Cenu noteikšanas struktūra
Product=Prece
 ;Label for product attribute.
ProductDiscount=Preces atlaide
 ;Label for discount component
ProductDiscountAttributes=Cenu atribūti preču atlaidēm
Published=Publicēta
Publishing=Publicēšana
Rank=Rangs
 ;Priority for price rules.
Rebate=Atlaide
 ;Label for rebate component
Revert=Atjaunot
SalesAgreement=Pārdošanas līgums
SalesOrderHeader=Pārdošanas pasūtījuma galvene
 ;Label for sales order header attribute.
SalesOrderLine=Pārdošanas pasūtījuma rinda
 ;Label for sales order line attribute.
SalesTradeAgreement=Tirdzniecības līgums
 ;Label for trade agreement component
ShippingDiscount=Piegādes atlaide
ShippingDiscountAttributes=Cenu atribūti piegādes atlaidēm
TenderDiscount=Norēķinu atlaide
TenderDiscountAttributes=Cenu atribūti norēķinu atlaidēm
TradeAgreementAttributes=Cenu atribūti tirdzniecības līgumiem
 ;Price attributes for trade agreements
UnifiedPricingFeatureLabel=(Nepabeigts) Cenu noteikšanas pārvaldība
 ;Feature name for unified pricing management
UnifiedPricingFeatureSummary=Cenu noteikšanas pārvaldības modulis nodrošina centralizētu platformu cenu noteikšanas vadītājiem, lai plānotu, konfigurētu, pārvaldītu, simulētu un uzraudzītu universālā kanāla cenu noteikšanas stratēģijas. Ja šis līdzeklis ir iespējots, organizācijas var iestatīt elastīgas cenu noteikšanas struktūras, izmantojot vairākus cenu komponentus, piemēram, vispārējās bāzes cenas, ilgtermiņa darījumus, īstermiņa akcijas un retrospektīvas atlaides. Cenu noteikšanas kārtulas var definēt, pamatojoties uz produkta, klienta un pasūtījuma atribūtiem. Kontekstuālo cenu noteikšanu var ieviest dažādos segmentos, pamatojoties uz iepriekš definētiem nosacījumiem. Reāllaika cenu noteikšanas aprēķinu nodrošina vienota cenu noteikšanas programma, kas konsekventi darbojas visos piegādes ķēdes, mazumtirdzniecības un e-komercijas biznesa procesos.
 ;Feature summary for unified pricing management
