Added=Tilføyd
AttributeWithComponentCode=Du kan ikke slette et prisattributt når det er koblet til en komponentkode.
AutoCharge=Automatisk gebyr
 ;Label for charge component
BasePrice=Basispris
CalculationSequence=Prissekvens
 ;Label for pricing calculation sequence
CannotDeleteDefaultTree=Standard pristre kan ikke slettes.
CannotInsertPriceTree=Bare ett pristre er tillatt.
Channel=Kanal
 ;Label for channel attribute.
ConcurrencyMode=Samtidighetsmodus
Customer=Kunde
 ;Label for customer attribute.
DefaultPriceTree=Standard pristre
 ;Label for default price tree
Deleted=Slettet
DeletePriceAttribute=Du er i ferd med å slette en post i prisattributter. Vil du slette posten?
Discount=Rabatt
 ;Label for discount component
Draft=Utkast
Fields=Felter
MaxAttributeNumber=Du kan ikke definere mer enn %1 attributter for en priskomponent.
MoveDown=Flytt ned
MoveUp=Flytt opp
PostingProfileName=Posteringsprofil
 ;Label for posting profile name
PriceAdjustment=Prisjustering
 ;Label for price adjustment component
PriceAdjustmentAttributes=Prisattributter for prisjusteringer
 ;Label for price adjustment attributes
PriceAttrbuteSource=Kilde
 ;Label for the source of price attributes
PriceAttribute=Prisattributt
PriceAttributeCatalog=Katalog
PriceAttributeColor=Farge
PriceAttributeConfiguration=Konfigurasjon
PriceAttributeCustAccountNum=Kundekonto
PriceAttributeCustGroup=Kundegruppe
PriceAttributeCustMarkupGroup=Kundetilleggsgruppe
PriceAttributeCustSegment=Segment
PriceAttributeCustType=Kundetype
PriceAttributeDataType=Prisattributtdatatype
 ;It's not public facing.
PriceAttributeDlvMode=Leveringsmiddel
PriceAttributeDlvModeMarkupGroup=Leveringsgebyrgruppe
PriceAttributeItemMarkupGroup=Varetilleggsgruppe
PriceAttributeName=Navn
 ;Label for the name of price attributes
PriceAttributeProcessStatus=Prosesstatus
 ;Label for price attribute process status
PriceAttributeProduct=Produkt
PriceAttributeProductCategory=Kategori
PriceAttributeProductVariant=Produktvariant
PriceAttributeProviderNotFound=Finner ingen prisattributtleverandører for %1.
 ;An error indicating customization is not correct.
PriceAttributeProviderNotSupported=Leverandøren %1 støtter ikke prisattributt %2.
 ;An error indicating customization is not correct.
PriceAttributePublish=Prisattributter er publisert.
PriceAttributeRetailAffiliation=Tilknytning
PriceAttributeRetailLoyaltyTier=Fordelsprogram
PriceAttributes=Prisattributter
 ;Label for price attributes form
PriceAttributeSite=Nettsted
PriceAttributeSize=Størrelse
PriceAttributeStatus=Prisattributtstatus
 ;It's not public facing.
PriceAttributeStyle=Stil
PriceAttributeType=Type
 ;Label for price attribute types
PriceAttributeTypeCustomFields=Tilpassede felter
 ;Label for customization pricing attributes
PriceAttributeTypeEcoResAttribute=Brukerdefinerte attributter
 ;Type of an attribute references EcoResAttribute
PriceAttributeTypePredefinedFields=Forhåndsdefinerte felter
 ;Type of a predefined attribute field
PriceAttributeWarehouse=Lager
PriceComponent=Priskomponent
 ;Label for price component
PriceComponentCodeCurrencyMode=Samtidighetsmodus
 ;Label for price component code concurrency mode
PriceComponentCodeName=Priskomponentkode
 ;Label for price component code name
PriceComponentCodes=Priskomponentkoder
 ;Label for price component codes form
PriceGroupAttributes=Prisattributter for prisgrupper
 ;Price attributes for price groups
PriceGroupPricingRuleLink=Kobling mellom prisgruppe og prissettingsregel
 ;Label for PriceGroupPricingRuleLink table
PriceGroups=Prisgrupper
 ;Label for price group
PricePublishStatus=Publiseringsstatus
PriceTrees=Pristrær
 ;Label for price trees
PricingRuleApplicabilities=Prisattributtverdier
 ;Label for pricing rule applicability
PricingRuleApplicabilityLookupReference=Referanser til relevansregel for prissetting
 ;Label for pricing rule applicability references
PricingStructure=Prissettingsstruktur
Product=Produkt
 ;Label for product attribute.
ProductDiscount=Produktrabatt
 ;Label for discount component
ProductDiscountAttributes=Prisattributter for produktrabatter
Published=Publisert
Publishing=Publisering
Rank=Rangering
 ;Priority for price rules.
Rebate=Rabatt
 ;Label for rebate component
Revert=Gjenopprett
SalesAgreement=Salgsavtale
SalesOrderHeader=Topptekst i salgsordre
 ;Label for sales order header attribute.
SalesOrderLine=Salgsordrelinje
 ;Label for sales order line attribute.
SalesTradeAgreement=Salgshandelsavtale
 ;Label for trade agreement component
ShippingDiscount=Leveringsrabatt
ShippingDiscountAttributes=Prisattributter for forsendelsesrabatter
TenderDiscount=Betalingsmiddelrabatt
TenderDiscountAttributes=Prisattributter for betalingsmiddelrabatter
TradeAgreementAttributes=Prisattributter for handelsavtaler
 ;Price attributes for trade agreements
UnifiedPricingFeatureLabel=(Ufullstendig) Prisingsstyring
 ;Feature name for unified pricing management
UnifiedPricingFeatureSummary=Modulen for prisingsstyring gir en sentral plattform for prissettingsansvarlige til å planlegge, konfigurere, administrere, simulere og overvåke prissettingsstrategier for omnikanal. Når denne funksjonen er aktivert, kan organisasjoner definere fleksible prissettingsstrukturer ved hjelp av flere priskomponenter, for eksempel generelle basispriser, langsiktige avtaler, kortsiktige kampanjer og tilbakevirkende rabatter. Prissettingsregler kan defineres basert på produkt-, kunde- og ordreattributter. Kontekstbasert prissetting kan rulles ut til ulike segmenter basert på forhåndsdefinerte betingelser. Beregning av sanntidsprising drives av en enhetlig prissettingsmotor som fungerer konsekvent i alle forretningsprosesser for forsyningskjede, detaljhandel og netthandel.
 ;Feature summary for unified pricing management
