Added=Eklendi
AttributeWithComponentCode=Bir bileşen koduna bağlı fiyat özniteliğini silemezsiniz.
AutoCharge=Otomatik masraf
 ;Label for charge component
BasePrice=Taban fiyat
CalculationSequence=Fiyatlandırma sırası
 ;Label for pricing calculation sequence
CannotDeleteDefaultTree=Varsayılan fiyat ağacı silinemez.
CannotInsertPriceTree=Yalnızca bir fiyat ağacına izin verilir.
Channel=Kanal
 ;Label for channel attribute.
ConcurrencyMode=Eşzamanlılık modu
Customer=Müşteri
 ;Label for customer attribute.
DefaultPriceTree=Varsayılan fiyat ağacı
 ;Label for default price tree
Deleted=Silindi
DeletePriceAttribute=Fiyat özniteliklerindeki bir kaydı silmek üzeresiniz. Kayıt silinsin mi?
Discount=İskonto
 ;Label for discount component
Draft=Taslak
Fields=Alanlar
MaxAttributeNumber=Bir fiyat bileşeni için en fazla %1 öznitelik tanımlayabilirsiniz.
MoveDown=Aşağı taşı
MoveUp=Yukarı taşı
PostingProfileName=Deftere nakil profili
 ;Label for posting profile name
PriceAdjustment=Fiyat ayarlaması
 ;Label for price adjustment component
PriceAdjustmentAttributes=Fiyat ayarlamaları için fiyat öznitelikleri
 ;Label for price adjustment attributes
PriceAttrbuteSource=Kaynak
 ;Label for the source of price attributes
PriceAttribute=Fiyat özniteliği
PriceAttributeCatalog=Katalog
PriceAttributeColor=Renk
PriceAttributeConfiguration=Yapılandırma
PriceAttributeCustAccountNum=Müşteri hesabı
PriceAttributeCustGroup=Müşteri grubu
PriceAttributeCustMarkupGroup=Müşteri masrafları grubu
PriceAttributeCustSegment=Segment
PriceAttributeCustType=Müşteri türü
PriceAttributeDataType=Fiyat özniteliği veri türü
 ;It's not public facing.
PriceAttributeDlvMode=Teslimat şekli
PriceAttributeDlvModeMarkupGroup=Teslimat masrafı grupları
PriceAttributeItemMarkupGroup=Ürün masrafları grubu
PriceAttributeName=Ad
 ;Label for the name of price attributes
PriceAttributeProcessStatus=İşlem durumu
 ;Label for price attribute process status
PriceAttributeProduct=Ürün
PriceAttributeProductCategory=Kategori
PriceAttributeProductVariant=Ürün varyantı
PriceAttributeProviderNotFound=%1 için fiyat öznitelik sağlayıcısı bulunamadı.
 ;An error indicating customization is not correct.
PriceAttributeProviderNotSupported=%1 adlı sağlayıcı, %2 fiyat özniteliğini desteklemiyor.
 ;An error indicating customization is not correct.
PriceAttributePublish=Fiyat öznitelikleri başarıyla yayımlandı.
PriceAttributeRetailAffiliation=İlişki
PriceAttributeRetailLoyaltyTier=Bağlılık programı
PriceAttributes=Fiyat öznitelikleri
 ;Label for price attributes form
PriceAttributeSite=Site
PriceAttributeSize=Beden
PriceAttributeStatus=Fiyat öznitelik durumu
 ;It's not public facing.
PriceAttributeStyle=Stil
PriceAttributeType=Tür
 ;Label for price attribute types
PriceAttributeTypeCustomFields=Özel alanlar
 ;Label for customization pricing attributes
PriceAttributeTypeEcoResAttribute=Kullanıcı tanımlı öznitelikler
 ;Type of an attribute references EcoResAttribute
PriceAttributeTypePredefinedFields=Önceden tanımlı alanlar
 ;Type of a predefined attribute field
PriceAttributeWarehouse=Depo
PriceComponent=Fiyat bileşeni
 ;Label for price component
PriceComponentCodeCurrencyMode=Eşzamanlılık modu
 ;Label for price component code concurrency mode
PriceComponentCodeName=Fiyat bileşeni kodu
 ;Label for price component code name
PriceComponentCodes=Fiyat bileşeni kodları
 ;Label for price component codes form
PriceGroupAttributes=Fiyat grupları için fiyat öznitelikleri
 ;Price attributes for price groups
PriceGroupPricingRuleLink=Fiyat grubu ve fiyatlandırma kuralı arasındaki bağlantı
 ;Label for PriceGroupPricingRuleLink table
PriceGroups=Fiyat grupları
 ;Label for price group
PricePublishStatus=Yayımlama durumu
PriceTrees=Fiyat ağaçları
 ;Label for price trees
PricingRuleApplicabilities=Fiyat öznitelik değerleri
 ;Label for pricing rule applicability
PricingRuleApplicabilityLookupReference=Fiyatlandırma kuralı uygulanabilirlik referansları
 ;Label for pricing rule applicability references
PricingStructure=Fiyatlandırma yapısı
Product=Ürün
 ;Label for product attribute.
ProductDiscount=Ürün iskontosu
 ;Label for discount component
ProductDiscountAttributes=Ürün iskontoları için fiyat öznitelikleri
Published=Yayımlandı
Publishing=Yayıncılık
Rank=Derece
 ;Priority for price rules.
Rebate=İndirim
 ;Label for rebate component
Revert=Geri al
SalesAgreement=Satış anlaşması
SalesOrderHeader=Satış siparişi başlığı
 ;Label for sales order header attribute.
SalesOrderLine=Satış siparişi satırı
 ;Label for sales order line attribute.
SalesTradeAgreement=Satış ticari anlaşması
 ;Label for trade agreement component
ShippingDiscount=Sevkiyat iskontosu
ShippingDiscountAttributes=Sevkiyat iskontoları için fiyat öznitelikleri
TenderDiscount=Ödeme iskontosu
TenderDiscountAttributes=Ödeme iskontoları için fiyat öznitelikleri
TradeAgreementAttributes=Ticari anlaşmalar için fiyat öznitelikleri
 ;Price attributes for trade agreements
UnifiedPricingFeatureLabel=(Tamamlanmadı) Fiyatlandırma yönetimi
 ;Feature name for unified pricing management
UnifiedPricingFeatureSummary=Fiyatlandırma yönetimi modülü, fiyatlandırma yöneticilerinin çok yönlü kanal fiyatlandırma stratejileri planlamak, yapılandırmak, yönetmek, simüle etmek ve izlemek için kullanabilecekleri merkezi bir platformdur. Bu özellik etkinleştirildiğinde kuruluşlar, genel taban fiyatlar, uzun vadeli anlaşmalar, kısa vadeli promosyonlar ve geriye dönük indirimler gibi birden fazla fiyat bileşeni kullanarak esnek fiyatlandırma yapıları ayarlayabilir. Fiyatlandırma kuralları ürün, müşteri ve sipariş özniteliklerine göre belirlenebilir. Bağlamsal fiyatlandırma, önceden tanımlı koşullara göre farklı segmentlere dağıtılabilir. Gerçek zamanlı fiyatlandırma hesaplaması tedarik zinciri, perakende ve e-ticaret iş süreçlerinde tutarlı şekilde çalışan birleşik bir fiyatlandırma altyapısı ile desteklenir.
 ;Feature summary for unified pricing management
