Added=Bætt við
AttributeWithComponentCode=Ekki er hægt að eyða verðeigind þegar hún er tengd við hlutakóða.
AutoCharge=Sjálfvirkt
 ;Label for charge component
BasePrice=Grunnverð
CalculationSequence=Verðlagningarröð
 ;Label for pricing calculation sequence
CannotDeleteDefaultTree=Ekki er hægt að eyða sjálfgefnu verðtré.
CannotInsertPriceTree=Aðeins eitt verðtré er leyfilegt.
Channel=Rás
 ;Label for channel attribute.
ConcurrencyMode=Samvinnslustilling
Customer=Viðskiptavinur
 ;Label for customer attribute.
DefaultPriceTree=Sjálfgefið verðtré
 ;Label for default price tree
Deleted=Eytt
DeletePriceAttribute=Þú ert að fara að eyða færslu í verðeigindum. Eyða færslu?
Discount=Afsláttur
 ;Label for discount component
Draft=Drög
Fields=Reitir
MaxAttributeNumber=Ekki er hægt að skilgreina fleiri en %1 eigindir fyrir verðhluta.
MoveDown=Flytja niður
MoveUp=Flytja upp
PostingProfileName=Bókunarregla
 ;Label for posting profile name
PriceAdjustment=Verðleiðrétting
 ;Label for price adjustment component
PriceAdjustmentAttributes=Verðeigindir fyrir verðleiðréttingar
 ;Label for price adjustment attributes
PriceAttrbuteSource=Uppruni
 ;Label for the source of price attributes
PriceAttribute=Verðeigind
PriceAttributeCatalog=Vörulisti
PriceAttributeColor=Litur
PriceAttributeConfiguration=Grunnstilling
PriceAttributeCustAccountNum=Viðskiptavinalykill
PriceAttributeCustGroup=Flokkur viðskiptavinar
PriceAttributeCustMarkupGroup=Gjaldaflokkur viðskiptavinar
PriceAttributeCustSegment=Hluti
PriceAttributeCustType=Gerð viðskiptavinar
PriceAttributeDataType=Gagnagerð verðeigindar
 ;It's not public facing.
PriceAttributeDlvMode=Afhendingarmáti
PriceAttributeDlvModeMarkupGroup=Gjaldaflokkur afhendingar
PriceAttributeItemMarkupGroup=Vörugjaldaflokkur
PriceAttributeName=Heiti
 ;Label for the name of price attributes
PriceAttributeProcessStatus=Staða ferlis
 ;Label for price attribute process status
PriceAttributeProduct=Vara
PriceAttributeProductCategory=Flokkur
PriceAttributeProductVariant=Afurðarafbrigði
PriceAttributeProviderNotFound=Enginn veita verðeigindar fannst fyrir %1.
 ;An error indicating customization is not correct.
PriceAttributeProviderNotSupported=Veitan %1 styður ekki verðeigind %2.
 ;An error indicating customization is not correct.
PriceAttributePublish=Verðeigindir hafa verið birtar.
PriceAttributeRetailAffiliation=Tengsl
PriceAttributeRetailLoyaltyTier=Vildarkerfi
PriceAttributes=Verðeigindir
 ;Label for price attributes form
PriceAttributeSite=Svæði
PriceAttributeSize=Stærð
PriceAttributeStatus=Staða verðeigindar
 ;It's not public facing.
PriceAttributeStyle=Stíll
PriceAttributeType=Gerð
 ;Label for price attribute types
PriceAttributeTypeCustomFields=Sérstilltir reitir
 ;Label for customization pricing attributes
PriceAttributeTypeEcoResAttribute=Notandaskilgreindar eigindir
 ;Type of an attribute references EcoResAttribute
PriceAttributeTypePredefinedFields=Fyrirframskilgreindir reitir
 ;Type of a predefined attribute field
PriceAttributeWarehouse=Vöruhús
PriceComponent=Verðhluti
 ;Label for price component
PriceComponentCodeCurrencyMode=Samvinnslustilling
 ;Label for price component code concurrency mode
PriceComponentCodeName=Kóði verðhluta
 ;Label for price component code name
PriceComponentCodes=Kóðar verðhluta
 ;Label for price component codes form
PriceGroupAttributes=Verðeigindir fyrir verðflokka
 ;Price attributes for price groups
PriceGroupPricingRuleLink=Tengsl milli verðflokks og verðlagningarreglu
 ;Label for PriceGroupPricingRuleLink table
PriceGroups=Verðflokkar
 ;Label for price group
PricePublishStatus=Birtingarstaða
PriceTrees=Verðtré
 ;Label for price trees
PricingRuleApplicabilities=Gildi verðeigindar
 ;Label for pricing rule applicability
PricingRuleApplicabilityLookupReference=Tilvísanir í gildissvið verðlagningarreglu
 ;Label for pricing rule applicability references
PricingStructure=Verðuppbygging
Product=Afurð
 ;Label for product attribute.
ProductDiscount=Afurðarafsláttur
 ;Label for discount component
ProductDiscountAttributes=Verðeigindir fyrir vöruafslætti
Published=Birt
Publishing=Útgáfa
Rank=Vægi
 ;Priority for price rules.
Rebate=Eftirágreiddur afsláttur
 ;Label for rebate component
Revert=Afturkalla
SalesAgreement=Sölusamningur
SalesOrderHeader=Sölupöntunarhaus
 ;Label for sales order header attribute.
SalesOrderLine=Sölupöntunarlína
 ;Label for sales order line attribute.
SalesTradeAgreement=Sölusamningur
 ;Label for trade agreement component
ShippingDiscount=Sendingarafsláttur
ShippingDiscountAttributes=Verðeigindir fyrir sendingarafslætti
TenderDiscount=Útboðsafsláttur
TenderDiscountAttributes=Verðeigindir fyrir útboðsafslætti
TradeAgreementAttributes=Verðeigindir fyrir verðsamninga
 ;Price attributes for trade agreements
UnifiedPricingFeatureLabel=(Ólokið) Verðstjórnun
 ;Feature name for unified pricing management
UnifiedPricingFeatureSummary=Verðstjórnunareining er miðlægur verkvangur fyrir verðstjóra til að skipuleggja, stilla, hafa umsjón með, herma eftir og fylgjast með fjölrása verðlagningarstefnu. Með þennan eiginleika virkan geta fyrirtæki sett upp sveigjanlegar verðlagningar með mörgum verðþáttum eins og almennu grunnverði, langtímatilboðum, skammtímakynningum og eftirágreiddum afsláttum. Hægt er að skilgreina verðreglur út frá eigindum vöru, viðskiptavinar og pöntunar. Hægt er að birta samhengisverð í mismunandi hlutum út frá fyrirframskilgreindum skilyrðum. Verðútreikningur í rauntíma er knúinn af samræmdri verðvél sem vinnur jafnt á milli aðfangakeðju-, smásölu- og rafrænna viðskiptaferla.
 ;Feature summary for unified pricing management
