Added=Додано
AttributeWithComponentCode=Не можна видалити атрибут ціни, якщо він пов’язаний із кодом компонента.
AutoCharge=Автоматичне нарахування
 ;Label for charge component
BasePrice=Основна ціна
CalculationSequence=Послідовність ціноутворення
 ;Label for pricing calculation sequence
CannotDeleteDefaultTree=Стандартне дерево цін неможливо видалити.
CannotInsertPriceTree=Може існувати лише одно дерево цін.
Channel=Канал
 ;Label for channel attribute.
ConcurrencyMode=Режим суміщення
Customer=Клієнт
 ;Label for customer attribute.
DefaultPriceTree=Стандартне дерево цін
 ;Label for default price tree
Deleted=Видалено
DeletePriceAttribute=Ви видаляєте запис в атрибутах ціни. Видалити запис?
Discount=Знижка
 ;Label for discount component
Draft=Чернетка
Fields=Поля
MaxAttributeNumber=Ви не можете визначити більше такої кількості атрибутів для компонента ціни: %1.
MoveDown=Перемістити вниз
MoveUp=Перемістити вгору
PostingProfileName=Профіль рознесень
 ;Label for posting profile name
PriceAdjustment=Коригування ціни
 ;Label for price adjustment component
PriceAdjustmentAttributes=Атрибути ціни для коригування цін
 ;Label for price adjustment attributes
PriceAttrbuteSource=Джерело
 ;Label for the source of price attributes
PriceAttribute=Атрибут ціни
PriceAttributeCatalog=Каталог
PriceAttributeColor=Колір
PriceAttributeConfiguration=Налаштування
PriceAttributeCustAccountNum=Рахунок клієнта
PriceAttributeCustGroup=Група клієнтів
PriceAttributeCustMarkupGroup=Група накладних витрат за клієнтами
PriceAttributeCustSegment=Сегмент
PriceAttributeCustType=Тип клієнта
PriceAttributeDataType=Тип дати атрибута ціни
 ;It's not public facing.
PriceAttributeDlvMode=Спосіб доставки
PriceAttributeDlvModeMarkupGroup=Група стягнень за доставку
PriceAttributeItemMarkupGroup=Група накладних витрат за позиціями
PriceAttributeName=П. І. Б. або назва
 ;Label for the name of price attributes
PriceAttributeProcessStatus=Стан процесу
 ;Label for price attribute process status
PriceAttributeProduct=Продукт
PriceAttributeProductCategory=Категорія
PriceAttributeProductVariant=Варіант продукту
PriceAttributeProviderNotFound=Не знайдено жодного постачальника атрибутів ціни для %1.
 ;An error indicating customization is not correct.
PriceAttributeProviderNotSupported=Постачальник %1 не підтримує атрибут ціни %2.
 ;An error indicating customization is not correct.
PriceAttributePublish=Атрибути цін успішно опубліковано.
PriceAttributeRetailAffiliation=Приналежність
PriceAttributeRetailLoyaltyTier=Програма лояльності
PriceAttributes=Атрибути ціни
 ;Label for price attributes form
PriceAttributeSite=Місцезнаходження
PriceAttributeSize=Розмір
PriceAttributeStatus=Стан рядка атрибута ціни
 ;It's not public facing.
PriceAttributeStyle=Стиль
PriceAttributeType=Тип
 ;Label for price attribute types
PriceAttributeTypeCustomFields=Настроювані поля
 ;Label for customization pricing attributes
PriceAttributeTypeEcoResAttribute=Визначений користувачем атрибут
 ;Type of an attribute references EcoResAttribute
PriceAttributeTypePredefinedFields=Попередньо визначені поля
 ;Type of a predefined attribute field
PriceAttributeWarehouse=Склад
PriceComponent=Компонент ціни
 ;Label for price component
PriceComponentCodeCurrencyMode=Режим суміщення
 ;Label for price component code concurrency mode
PriceComponentCodeName=Код компонента ціни
 ;Label for price component code name
PriceComponentCodes=Коди компонентів ціни
 ;Label for price component codes form
PriceGroupAttributes=Атрибути ціни для цінових груп
 ;Price attributes for price groups
PriceGroupPricingRuleLink=Зв’язок між ціновою групою та правилом ціноутворення
 ;Label for PriceGroupPricingRuleLink table
PriceGroups=Цінові групи
 ;Label for price group
PricePublishStatus=Стан публікації
PriceTrees=Дерева цін
 ;Label for price trees
PricingRuleApplicabilities=Значення атрибутів ціни
 ;Label for pricing rule applicability
PricingRuleApplicabilityLookupReference=Посилання на застосування правил ціноутворення
 ;Label for pricing rule applicability references
PricingStructure=Структура ціноутворення
Product=Продукт
 ;Label for product attribute.
ProductDiscount=Знижка на товар
 ;Label for discount component
ProductDiscountAttributes=Атрибути ціни для знижок на продукти
Published=Опубліковано
Publishing=Видавництво
Rank=Рейтинг
 ;Priority for price rules.
Rebate=Відшкодування
 ;Label for rebate component
Revert=Повернути
SalesAgreement=Угода про продаж
SalesOrderHeader=Заголовок замовлення на продаж
 ;Label for sales order header attribute.
SalesOrderLine=Рядок замовлення на продаж
 ;Label for sales order line attribute.
SalesTradeAgreement=Комерційна угода про продаж
 ;Label for trade agreement component
ShippingDiscount=Знижка на доставку
ShippingDiscountAttributes=Атрибути ціни для знижок на поставку
TenderDiscount=Знижка на основі платіжного засобу
TenderDiscountAttributes=Атрибути ціни для тендерних знижок
TradeAgreementAttributes=Атрибути ціни для комерційної угоди
 ;Price attributes for trade agreements
UnifiedPricingFeatureLabel=(Незавершено) Керування ціноутворенням
 ;Feature name for unified pricing management
UnifiedPricingFeatureSummary=Модуль керування ціноутворенням забезпечує централізовану платформу, за допомогою якої менеджери з ціноутворення можуть планувати, налаштовувати, моделювати й відстежувати омніканальні стратегії ціноутворення, а також керувати ними. Увімкнувши цю функцію, організації можуть налаштувати гнучку структуру ціноутворення, використовуючи численні компоненти ціни, як-от загальні базові ціни, довгострокові угоди, короткострокові акції та ретроспективні відшкодування. Правила ціноутворення можна визначити на основі атрибутів продукту, клієнта й замовлення. Контекстне ціноутворення можна застосовувати до різних сегментів на основі попередньо визначених умов. Обчислення для встановлення цін у реальному часі здійснюється за допомогою уніфікованої системи ціноутворення, що узгоджено працює в бізнес-процесах ланцюжка постачання, роздрібної торгівлі й електронної комерції.
 ;Feature summary for unified pricing management
