Added=Added
AttributeWithComponentCode=You can not delete a price attribute when it's linked to a component code.
AutoCharge=Auto-charge
 ;Label for charge component
BasePrice=Base price
CalculationSequence=Pricing sequence
 ;Label for pricing calculation sequence
CannotDeleteDefaultTree=Default price tree cannot be deleted.
CannotInsertPriceTree=Only one price tree is allowed.
Channel=Channel
 ;Label for channel attribute.
ConcurrencyMode=Concurrency mode
Customer=Customer
 ;Label for customer attribute.
DefaultPriceTree=Default price tree
 ;Label for default price tree
Deleted=Deleted
DeletePriceAttribute=You are about to delete a record in price attributes. Delete record?
Discount=Discount
 ;Label for discount component
Draft=Draft
Fields=Fields
MaxAttributeNumber=You can not define more than %1 attributes for a price component.
MoveDown=Move down
MoveUp=Move up
PostingProfileName=Posting profile
 ;Label for posting profile name
PriceAdjustment=Price adjustment
 ;Label for price adjustment component
PriceAdjustmentAttributes=Price attributes for price adjustments
 ;Label for price adjustment attributes
PriceAttrbuteSource=Source
 ;Label for the source of price attributes
PriceAttribute=Price attribute
PriceAttributeCatalog=Catalog
PriceAttributeColor=Color
PriceAttributeConfiguration=Configuration
PriceAttributeCustAccountNum=Customer account
PriceAttributeCustGroup=Customer group
PriceAttributeCustMarkupGroup=Customer charges group
PriceAttributeCustSegment=Segment
PriceAttributeCustType=Customer type
PriceAttributeDataType=Price attribute data type
 ;It's not public facing.
PriceAttributeDlvMode=Mode of delivery
PriceAttributeDlvModeMarkupGroup=Delivery charge group
PriceAttributeItemMarkupGroup=Item charges group
PriceAttributeName=Name
 ;Label for the name of price attributes
PriceAttributeProcessStatus=Process status
 ;Label for price attribute process status
PriceAttributeProduct=Product
PriceAttributeProductCategory=Category
PriceAttributeProductVariant=Product variant
PriceAttributeProviderNotFound=There is no price attribute provider found for %1.
 ;An error indicating customization is not correct.
PriceAttributeProviderNotSupported=The provider %1 does not support price attribute %2.
 ;An error indicating customization is not correct.
PriceAttributePublish=Price attributes have been successfully published.
PriceAttributeRetailAffiliation=Affiliation
PriceAttributeRetailLoyaltyTier=Loyalty program
PriceAttributes=Price attributes
 ;Label for price attributes form
PriceAttributeSite=Site
PriceAttributeSize=Size
PriceAttributeStatus=Price attribute status
 ;It's not public facing.
PriceAttributeStyle=Style
PriceAttributeType=Type
 ;Label for price attribute types
PriceAttributeTypeCustomFields=Custom fields
 ;Label for customization pricing attributes
PriceAttributeTypeEcoResAttribute=User-defined attributes
 ;Type of an attribute references EcoResAttribute
PriceAttributeTypePredefinedFields=Predefined fields
 ;Type of a predefined attribute field
PriceAttributeWarehouse=Warehouse
PriceComponent=Price component
 ;Label for price component
PriceComponentCodeCurrencyMode=Concurrency mode
 ;Label for price component code concurrency mode
PriceComponentCodeName=Price component code
 ;Label for price component code name
PriceComponentCodes=Price component codes
 ;Label for price component codes form
PriceGroupAttributes=Price attributes for price groups
 ;Price attributes for price groups
PriceGroupPricingRuleLink=Linkage between price group and pricing rule
 ;Label for PriceGroupPricingRuleLink table
PriceGroups=Price groups
 ;Label for price group
PricePublishStatus=Publish status
PriceTrees=Price trees
 ;Label for price trees
PricingRuleApplicabilities=Price attribute values
 ;Label for pricing rule applicability
PricingRuleApplicabilityLookupReference=Pricing rule applicability references
 ;Label for pricing rule applicability references
PricingStructure=Pricing structure
Product=Product
 ;Label for product attribute.
ProductDiscount=Product discount
 ;Label for discount component
ProductDiscountAttributes=Price attributes for product discounts
Published=Published
Publishing=Publishing
Rank=Rank
 ;Priority for price rules.
Rebate=Rebate
 ;Label for rebate component
Revert=Revert
SalesAgreement=Sales agreement
SalesOrderHeader=Sales order header
 ;Label for sales order header attribute.
SalesOrderLine=Sales order line
 ;Label for sales order line attribute.
SalesTradeAgreement=Sales trade agreement
 ;Label for trade agreement component
ShippingDiscount=Shipping discount
ShippingDiscountAttributes=Price attributes for shipping discounts
TenderDiscount=Tender discount
TenderDiscountAttributes=Price attributes for tender discounts
TradeAgreementAttributes=Price attributes for trade agreements
 ;Price attributes for trade agreements
UnifiedPricingFeatureLabel=(Incomplete) Pricing management
 ;Feature name for unified pricing management
UnifiedPricingFeatureSummary=Pricing management module provides a centralized platform for pricing managers to plan, configure, manage, simulate and monitor omnichannel pricing strategies. With this feature enabled, organizations can set up flexible pricing structures using multiple price components such as general base prices, long-term deals, short-term promotions, and retrospective rebates. Pricing rules can be defined based on product, customer, and order attributes. Contextual pricing can be rolled out to different segments based on predefined conditions. Real-time pricing calculation is powered by a unified pricing engine that works consistently across supply chain, retail, and e-commerce business processes.
 ;Feature summary for unified pricing management
