Added=Přidáno
AttributeWithComponentCode=Atribut ceny nelze odstranit, pokud je propojen s kódem komponenty.
AutoCharge=Automatické náklady
 ;Label for charge component
BasePrice=Základní cena
CalculationSequence=Cenová posloupnost
 ;Label for pricing calculation sequence
CannotDeleteDefaultTree=Výchozí cenový strom nelze odstranit.
CannotInsertPriceTree=Je povolen pouze jeden cenový strom.
Channel=Kanál
 ;Label for channel attribute.
ConcurrencyMode=Režim souběžnosti
Customer=Zákazník
 ;Label for customer attribute.
DefaultPriceTree=Výchozí cenový strom
 ;Label for default price tree
Deleted=Odstraněno
DeletePriceAttribute=Chystáte se odstranit záznam v atributech ceny. Odstranit záznam?
Discount=Sleva
 ;Label for discount component
Draft=Koncept
Fields=Pole
MaxAttributeNumber=Pro složku ceny nelze definovat více než %1 atributů.
MoveDown=Přesunout dolů
MoveUp=Přesunout nahoru
PostingProfileName=Účetní profil
 ;Label for posting profile name
PriceAdjustment=Úprava ceny
 ;Label for price adjustment component
PriceAdjustmentAttributes=Atributy ceny pro úpravy cen
 ;Label for price adjustment attributes
PriceAttrbuteSource=Zdroj
 ;Label for the source of price attributes
PriceAttribute=Atribut ceny
PriceAttributeCatalog=Katalog
PriceAttributeColor=Barva
PriceAttributeConfiguration=Konfigurace
PriceAttributeCustAccountNum=Účet zákazníka
PriceAttributeCustGroup=Skupina zákazníků
PriceAttributeCustMarkupGroup=Skupina nákladů zákazníka
PriceAttributeCustSegment=Segment
PriceAttributeCustType=Typ zákazníka
PriceAttributeDataType=Datový typ atributů ceny
 ;It's not public facing.
PriceAttributeDlvMode=Způsob dodání
PriceAttributeDlvModeMarkupGroup=Skupina nákladů dodání
PriceAttributeItemMarkupGroup=Skupina nákladů zboží
PriceAttributeName=Jméno
 ;Label for the name of price attributes
PriceAttributeProcessStatus=Stav procesu
 ;Label for price attribute process status
PriceAttributeProduct=Produkt
PriceAttributeProductCategory=Kategorie
PriceAttributeProductVariant=Varianta produktu
PriceAttributeProviderNotFound=Nebyl nalezen žádný poskytovatel atributu ceny pro %1.
 ;An error indicating customization is not correct.
PriceAttributeProviderNotSupported=Poskytovatel %1 nepodporuje atribut ceny %2.
 ;An error indicating customization is not correct.
PriceAttributePublish=Atributy ceny byly úspěšně publikovány.
PriceAttributeRetailAffiliation=Umístění
PriceAttributeRetailLoyaltyTier=Věrnostní program
PriceAttributes=Atributy cen
 ;Label for price attributes form
PriceAttributeSite=Pracoviště
PriceAttributeSize=Velikost
PriceAttributeStatus=Stav atributů ceny
 ;It's not public facing.
PriceAttributeStyle=Styl
PriceAttributeType=Typ
 ;Label for price attribute types
PriceAttributeTypeCustomFields=Vlastní pole
 ;Label for customization pricing attributes
PriceAttributeTypeEcoResAttribute=Uživatelem definované atributy
 ;Type of an attribute references EcoResAttribute
PriceAttributeTypePredefinedFields=Předdefinovaná pole
 ;Type of a predefined attribute field
PriceAttributeWarehouse=Sklad
PriceComponent=Komponenta ceny
 ;Label for price component
PriceComponentCodeCurrencyMode=Režim souběžnosti
 ;Label for price component code concurrency mode
PriceComponentCodeName=Kód komponenty ceny
 ;Label for price component code name
PriceComponentCodes=Kódy komponenty ceny
 ;Label for price component codes form
PriceGroupAttributes=Atributy ceny pro cenové skupiny
 ;Price attributes for price groups
PriceGroupPricingRuleLink=Vazba mezi cenovou skupinou a cenovým pravidlem
 ;Label for PriceGroupPricingRuleLink table
PriceGroups=Cenové skupiny
 ;Label for price group
PricePublishStatus=Stav publikování
PriceTrees=Cenové stromy
 ;Label for price trees
PricingRuleApplicabilities=Hodnoty atributu ceny
 ;Label for pricing rule applicability
PricingRuleApplicabilityLookupReference=Odkazy na použitelnost cenových pravidel
 ;Label for pricing rule applicability references
PricingStructure=Struktura ceny
Product=Produkt
 ;Label for product attribute.
ProductDiscount=Sleva na produkt
 ;Label for discount component
ProductDiscountAttributes=Atributy ceny pro slevy produktů
Published=Publikováno
Publishing=Publikování
Rank=Pořadí
 ;Priority for price rules.
Rebate=Rabat
 ;Label for rebate component
Revert=Vrátit
SalesAgreement=Prodejní smlouva
SalesOrderHeader=Záhlaví prodejní objednávky
 ;Label for sales order header attribute.
SalesOrderLine=Řádek prodejní objednávky
 ;Label for sales order line attribute.
SalesTradeAgreement=Prodejní obchodní smlouva
 ;Label for trade agreement component
ShippingDiscount=Přepravní sleva
ShippingDiscountAttributes=Atributy ceny pro přepravní slevu
TenderDiscount=Sleva pro způsob úhrady
TenderDiscountAttributes=Atributy ceny pro slevy pro způsob úhrady
TradeAgreementAttributes=Atributy ceny pro obchodní smlouvy
 ;Price attributes for trade agreements
UnifiedPricingFeatureLabel=(Neúplné) Správa cen
 ;Feature name for unified pricing management
UnifiedPricingFeatureSummary=Modul Správa cen poskytuje centralizovanou platformu pro správce cen, která jim umožňuje plánovat, konfigurovat, spravovat, simulovat a monitorovat omnikanálové cenové strategie. S touto funkcí mohou organizace nastavit flexibilní cenové struktury s využitím několika cenových složek, jako jsou obecné základní ceny, dlouhodobé nabídky, krátkodobé akce a retrospektivní rabaty. Pravidla tvorby cen lze definovat na základě atributů produktu, zákazníka a objednávky. Kontextové ceny lze zavádět pro různé segmenty na základě předem definovaných podmínek. Výpočet cen v reálném čase zajišťuje jednotný cenový modul, který funguje konzistentně napříč obchodními procesy dodavatelského řetězce, maloobchodu a elektronického obchodu.
 ;Feature summary for unified pricing management
